filename,file_size,file_attributes,region_count,region_id,region_shape_attributes,region_attributes,height,name,width,x,y,trainpath,labelpath,mask_percentage,labels,ymax,xmax
1.2.276.0.7230010.3.1.4.8323329.300.1517875162.258081.png,420519,{},1,0,"{""name"":""rect"",""x"":214,""y"":171,""width"":740,""height"":601}",{},601,rect,740,214,171,/home/dianwen/SIIM_ACR/train/images/1024/dicom/1.2.276.0.7230010.3.1.4.8323329.300.1517875162.258081.png,/home/dianwen/SIIM_ACR/train/images/1024/mask/1.2.276.0.7230010.3.1.4.8323329.300.1517875162.258081.png,0.002735137939453125,1.0,772,954
1.2.276.0.7230010.3.1.4.8323329.301.1517875162.280319.png,425620,{},1,0,"{""name"":""rect"",""x"":161,""y"":54,""width"":745,""height"":860}",{},860,rect,745,161,54,/home/dianwen/SIIM_ACR/train/images/1024/dicom/1.2.276.0.7230010.3.1.4.8323329.301.1517875162.280319.png,/home/dianwen/SIIM_ACR/train/images/1024/mask/1.2.276.0.7230010.3.1.4.8323329.301.1517875162.280319.png,0.009663581848144531,1.0,914,906
1.2.276.0.7230010.3.1.4.8323329.302.1517875162.286330.png,398688,{},1,0,"{""name"":""rect"",""x"":40,""y"":39,""width"":893,""height"":940}",{},940,rect,893,40,39,/home/dianwen/SIIM_ACR/train/images/1024/dicom/1.2.276.0.7230010.3.1.4.8323329.302.1517875162.286330.png,/home/dianwen/SIIM_ACR/train/images/1024/mask/1.2.276.0.7230010.3.1.4.8323329.302.1517875162.286330.png,0.0,0.0,979,933
1.2.276.0.7230010.3.1.4.8323329.303.1517875162.295039.png,395720,{},1,0,"{""name"":""rect"",""x"":100,""y"":69,""width"":861,""height"":857}",{},857,rect,861,100,69,/home/dianwen/SIIM_ACR/train/images/1024/dicom/1.2.276.0.7230010.3.1.4.8323329.303.1517875162.295039.png,/home/dianwen/SIIM_ACR/train/images/1024/mask/1.2.276.0.7230010.3.1.4.8323329.303.1517875162.295039.png,0.0011444091796875,1.0,926,961
1.2.276.0.7230010.3.1.4.8323329.304.1517875162.301989.png,421197,{},1,0,"{""name"":""rect"",""x"":100,""y"":100,""width"":837,""height"":788}",{},788,rect,837,100,100,/home/dianwen/SIIM_ACR/train/images/1024/dicom/1.2.276.0.7230010.3.1.4.8323329.304.1517875162.301989.png,/home/dianwen/SIIM_ACR/train/images/1024/mask/1.2.276.0.7230010.3.1.4.8323329.304.1517875162.301989.png,0.0,0.0,888,937
1.2.276.0.7230010.3.1.4.8323329.305.1517875162.307235.png,428197,{},1,0,"{""name"":""rect"",""x"":146,""y"":154,""width"":773,""height"":731}",{},731,rect,773,146,154,/home/dianwen/SIIM_ACR/train/images/1024/dicom/1.2.276.0.7230010.3.1.4.8323329.305.1517875162.307235.png,/home/dianwen/SIIM_ACR/train/images/1024/mask/1.2.276.0.7230010.3.1.4.8323329.305.1517875162.307235.png,0.0019664764404296875,1.0,885,919
1.2.276.0.7230010.3.1.4.8323329.306.1517875162.312801.png,379947,{},1,0,"{""name"":""rect"",""x"":87,""y"":227,""width"":734,""height"":631}",{},631,rect,734,87,227,/home/dianwen/SIIM_ACR/train/images/1024/dicom/1.2.276.0.7230010.3.1.4.8323329.306.1517875162.312801.png,/home/dianwen/SIIM_ACR/train/images/1024/mask/1.2.276.0.7230010.3.1.4.8323329.306.1517875162.312801.png,0.0012989044189453125,1.0,858,821
1.2.276.0.7230010.3.1.4.8323329.307.1517875162.311533.png,403712,{},1,0,"{""name"":""rect"",""x"":137,""y"":39,""width"":719,""height"":642}",{},642,rect,719,137,39,/home/dianwen/SIIM_ACR/train/images/1024/dicom/1.2.276.0.7230010.3.1.4.8323329.307.1517875162.311533.png,/home/dianwen/SIIM_ACR/train/images/1024/mask/1.2.276.0.7230010.3.1.4.8323329.307.1517875162.311533.png,0.06595464050769806,1.0,681,856
1.2.276.0.7230010.3.1.4.8323329.308.1517875162.318641.png,410651,{},1,0,"{""name"":""rect"",""x"":204,""y"":117,""width"":726,""height"":539}",{},539,rect,726,204,117,/home/dianwen/SIIM_ACR/train/images/1024/dicom/1.2.276.0.7230010.3.1.4.8323329.308.1517875162.318641.png,/home/dianwen/SIIM_ACR/train/images/1024/mask/1.2.276.0.7230010.3.1.4.8323329.308.1517875162.318641.png,0.0,0.0,656,930
1.2.276.0.7230010.3.1.4.8323329.309.1517875162.328197.png,416406,{},1,0,"{""name"":""rect"",""x"":108,""y"":83,""width"":777,""height"":897}",{},897,rect,777,108,83,/home/dianwen/SIIM_ACR/train/images/1024/dicom/1.2.276.0.7230010.3.1.4.8323329.309.1517875162.328197.png,/home/dianwen/SIIM_ACR/train/images/1024/mask/1.2.276.0.7230010.3.1.4.8323329.309.1517875162.328197.png,0.0,0.0,980,885
1.2.276.0.7230010.3.1.4.8323329.310.1517875162.344702.png,436293,{},1,0,"{""name"":""rect"",""x"":102,""y"":91,""width"":842,""height"":589}",{},589,rect,842,102,91,/home/dianwen/SIIM_ACR/train/images/1024/dicom/1.2.276.0.7230010.3.1.4.8323329.310.1517875162.344702.png,/home/dianwen/SIIM_ACR/train/images/1024/mask/1.2.276.0.7230010.3.1.4.8323329.310.1517875162.344702.png,0.0,0.0,680,944
1.2.276.0.7230010.3.1.4.8323329.311.1517875162.347660.png,418517,{},1,0,"{""name"":""rect"",""x"":106,""y"":92,""width"":812,""height"":852}",{},852,rect,812,106,92,/home/dianwen/SIIM_ACR/train/images/1024/dicom/1.2.276.0.7230010.3.1.4.8323329.311.1517875162.347660.png,/home/dianwen/SIIM_ACR/train/images/1024/mask/1.2.276.0.7230010.3.1.4.8323329.311.1517875162.347660.png,0.0,0.0,944,918
1.2.276.0.7230010.3.1.4.8323329.312.1517875162.342028.png,381136,{},1,0,"{""name"":""rect"",""x"":160,""y"":105,""width"":784,""height"":788}",{},788,rect,784,160,105,/home/dianwen/SIIM_ACR/train/images/1024/dicom/1.2.276.0.7230010.3.1.4.8323329.312.1517875162.342028.png,/home/dianwen/SIIM_ACR/train/images/1024/mask/1.2.276.0.7230010.3.1.4.8323329.312.1517875162.342028.png,0.0,0.0,893,944
1.2.276.0.7230010.3.1.4.8323329.314.1517875162.344457.png,285753,{},1,0,"{""name"":""rect"",""x"":259,""y"":116,""width"":635,""height"":577}",{},577,rect,635,259,116,/home/dianwen/SIIM_ACR/train/images/1024/dicom/1.2.276.0.7230010.3.1.4.8323329.314.1517875162.344457.png,/home/dianwen/SIIM_ACR/train/images/1024/mask/1.2.276.0.7230010.3.1.4.8323329.314.1517875162.344457.png,0.0,0.0,693,894
1.2.276.0.7230010.3.1.4.8323329.315.1517875162.341342.png,384298,{},1,0,"{""name"":""rect"",""x"":162,""y"":92,""width"":696,""height"":751}",{},751,rect,696,162,92,/home/dianwen/SIIM_ACR/train/images/1024/dicom/1.2.276.0.7230010.3.1.4.8323329.315.1517875162.341342.png,/home/dianwen/SIIM_ACR/train/images/1024/mask/1.2.276.0.7230010.3.1.4.8323329.315.1517875162.341342.png,0.004177093505859375,1.0,843,858
1.2.276.0.7230010.3.1.4.8323329.316.1517875162.351639.png,429750,{},1,0,"{""name"":""rect"",""x"":44,""y"":106,""width"":879,""height"":663}",{},663,rect,879,44,106,/home/dianwen/SIIM_ACR/train/images/1024/dicom/1.2.276.0.7230010.3.1.4.8323329.316.1517875162.351639.png,/home/dianwen/SIIM_ACR/train/images/1024/mask/1.2.276.0.7230010.3.1.4.8323329.316.1517875162.351639.png,0.0,0.0,769,923
1.2.276.0.7230010.3.1.4.8323329.317.1517875162.369996.png,406043,{},1,0,"{""name"":""rect"",""x"":66,""y"":157,""width"":810,""height"":674}",{},674,rect,810,66,157,/home/dianwen/SIIM_ACR/train/images/1024/dicom/1.2.276.0.7230010.3.1.4.8323329.317.1517875162.369996.png,/home/dianwen/SIIM_ACR/train/images/1024/mask/1.2.276.0.7230010.3.1.4.8323329.317.1517875162.369996.png,0.0,0.0,831,876
1.2.276.0.7230010.3.1.4.8323329.318.1517875162.378490.png,335878,{},1,0,"{""name"":""rect"",""x"":121,""y"":171,""width"":689,""height"":740}",{},740,rect,689,121,171,/home/dianwen/SIIM_ACR/train/images/1024/dicom/1.2.276.0.7230010.3.1.4.8323329.318.1517875162.378490.png,/home/dianwen/SIIM_ACR/train/images/1024/mask/1.2.276.0.7230010.3.1.4.8323329.318.1517875162.378490.png,0.0,0.0,911,810
1.2.276.0.7230010.3.1.4.8323329.319.1517875162.366125.png,396020,{},1,0,"{""name"":""rect"",""x"":239,""y"":197,""width"":776,""height"":814}",{},814,rect,776,239,197,/home/dianwen/SIIM_ACR/train/images/1024/dicom/1.2.276.0.7230010.3.1.4.8323329.319.1517875162.366125.png,/home/dianwen/SIIM_ACR/train/images/1024/mask/1.2.276.0.7230010.3.1.4.8323329.319.1517875162.366125.png,0.0,0.0,1011,1015
1.2.276.0.7230010.3.1.4.8323329.320.1517875162.379959.png,358281,{},1,0,"{""name"":""rect"",""x"":87,""y"":79,""width"":807,""height"":878}",{},878,rect,807,87,79,/home/dianwen/SIIM_ACR/train/images/1024/dicom/1.2.276.0.7230010.3.1.4.8323329.320.1517875162.379959.png,/home/dianwen/SIIM_ACR/train/images/1024/mask/1.2.276.0.7230010.3.1.4.8323329.320.1517875162.379959.png,0.0,0.0,957,894
1.2.276.0.7230010.3.1.4.8323329.321.1517875162.374614.png,313812,{},1,0,"{""name"":""rect"",""x"":118,""y"":83,""width"":810,""height"":732}",{},732,rect,810,118,83,/home/dianwen/SIIM_ACR/train/images/1024/dicom/1.2.276.0.7230010.3.1.4.8323329.321.1517875162.374614.png,/home/dianwen/SIIM_ACR/train/images/1024/mask/1.2.276.0.7230010.3.1.4.8323329.321.1517875162.374614.png,0.0,0.0,815,928
1.2.276.0.7230010.3.1.4.8323329.322.1517875162.392373.png,370263,{},1,0,"{""name"":""rect"",""x"":76,""y"":144,""width"":785,""height"":822}",{},822,rect,785,76,144,/home/dianwen/SIIM_ACR/train/images/1024/dicom/1.2.276.0.7230010.3.1.4.8323329.322.1517875162.392373.png,/home/dianwen/SIIM_ACR/train/images/1024/mask/1.2.276.0.7230010.3.1.4.8323329.322.1517875162.392373.png,0.0016651153564453125,1.0,966,861
1.2.276.0.7230010.3.1.4.8323329.323.1517875162.387830.png,346784,{},1,0,"{""name"":""rect"",""x"":68,""y"":123,""width"":843,""height"":628}",{},628,rect,843,68,123,/home/dianwen/SIIM_ACR/train/images/1024/dicom/1.2.276.0.7230010.3.1.4.8323329.323.1517875162.387830.png,/home/dianwen/SIIM_ACR/train/images/1024/mask/1.2.276.0.7230010.3.1.4.8323329.323.1517875162.387830.png,0.0,0.0,751,911
1.2.276.0.7230010.3.1.4.8323329.324.1517875162.391327.png,409742,{},1,0,"{""name"":""rect"",""x"":113,""y"":126,""width"":818,""height"":813}",{},813,rect,818,113,126,/home/dianwen/SIIM_ACR/train/images/1024/dicom/1.2.276.0.7230010.3.1.4.8323329.324.1517875162.391327.png,/home/dianwen/SIIM_ACR/train/images/1024/mask/1.2.276.0.7230010.3.1.4.8323329.324.1517875162.391327.png,0.010600090026855469,1.0,939,931
1.2.276.0.7230010.3.1.4.8323329.325.1517875162.384468.png,434223,{},1,0,"{""name"":""rect"",""x"":139,""y"":7,""width"":705,""height"":753}",{},753,rect,705,139,7,/home/dianwen/SIIM_ACR/train/images/1024/dicom/1.2.276.0.7230010.3.1.4.8323329.325.1517875162.384468.png,/home/dianwen/SIIM_ACR/train/images/1024/mask/1.2.276.0.7230010.3.1.4.8323329.325.1517875162.384468.png,0.006788253784179688,1.0,760,844
1.2.276.0.7230010.3.1.4.8323329.326.1517875162.400291.png,445349,{},1,0,"{""name"":""rect"",""x"":43,""y"":94,""width"":889,""height"":851}",{},851,rect,889,43,94,/home/dianwen/SIIM_ACR/train/images/1024/dicom/1.2.276.0.7230010.3.1.4.8323329.326.1517875162.400291.png,/home/dianwen/SIIM_ACR/train/images/1024/mask/1.2.276.0.7230010.3.1.4.8323329.326.1517875162.400291.png,0.0,0.0,945,932
1.2.276.0.7230010.3.1.4.8323329.327.1517875162.393558.png,449488,{},1,0,"{""name"":""rect"",""x"":130,""y"":25,""width"":863,""height"":778}",{},778,rect,863,130,25,/home/dianwen/SIIM_ACR/train/images/1024/dicom/1.2.276.0.7230010.3.1.4.8323329.327.1517875162.393558.png,/home/dianwen/SIIM_ACR/train/images/1024/mask/1.2.276.0.7230010.3.1.4.8323329.327.1517875162.393558.png,0.010814666748046877,1.0,803,993
1.2.276.0.7230010.3.1.4.8323329.328.1517875162.408327.png,396918,{},1,0,"{""name"":""rect"",""x"":142,""y"":43,""width"":680,""height"":605}",{},605,rect,680,142,43,/home/dianwen/SIIM_ACR/train/images/1024/dicom/1.2.276.0.7230010.3.1.4.8323329.328.1517875162.408327.png,/home/dianwen/SIIM_ACR/train/images/1024/mask/1.2.276.0.7230010.3.1.4.8323329.328.1517875162.408327.png,0.0,0.0,648,822
1.2.276.0.7230010.3.1.4.8323329.329.1517875162.405060.png,321054,{},1,0,"{""name"":""rect"",""x"":106,""y"":82,""width"":754,""height"":854}",{},854,rect,754,106,82,/home/dianwen/SIIM_ACR/train/images/1024/dicom/1.2.276.0.7230010.3.1.4.8323329.329.1517875162.405060.png,/home/dianwen/SIIM_ACR/train/images/1024/mask/1.2.276.0.7230010.3.1.4.8323329.329.1517875162.405060.png,0.0,0.0,936,860
1.2.276.0.7230010.3.1.4.8323329.330.1517875162.413920.png,435070,{},1,0,"{""name"":""rect"",""x"":110,""y"":49,""width"":743,""height"":793}",{},793,rect,743,110,49,/home/dianwen/SIIM_ACR/train/images/1024/dicom/1.2.276.0.7230010.3.1.4.8323329.330.1517875162.413920.png,/home/dianwen/SIIM_ACR/train/images/1024/mask/1.2.276.0.7230010.3.1.4.8323329.330.1517875162.413920.png,0.0,0.0,842,853
1.2.276.0.7230010.3.1.4.8323329.331.1517875162.418469.png,349721,{},1,0,"{""name"":""rect"",""x"":53,""y"":69,""width"":890,""height"":734}",{},734,rect,890,53,69,/home/dianwen/SIIM_ACR/train/images/1024/dicom/1.2.276.0.7230010.3.1.4.8323329.331.1517875162.418469.png,/home/dianwen/SIIM_ACR/train/images/1024/mask/1.2.276.0.7230010.3.1.4.8323329.331.1517875162.418469.png,0.0,0.0,803,943
1.2.276.0.7230010.3.1.4.8323329.332.1517875162.425631.png,410633,{},1,0,"{""name"":""rect"",""x"":151,""y"":70,""width"":688,""height"":742}",{},742,rect,688,151,70,/home/dianwen/SIIM_ACR/train/images/1024/dicom/1.2.276.0.7230010.3.1.4.8323329.332.1517875162.425631.png,/home/dianwen/SIIM_ACR/train/images/1024/mask/1.2.276.0.7230010.3.1.4.8323329.332.1517875162.425631.png,0.0,0.0,812,839
1.2.276.0.7230010.3.1.4.8323329.333.1517875162.422915.png,401319,{},1,0,"{""name"":""rect"",""x"":82,""y"":128,""width"":804,""height"":745}",{},745,rect,804,82,128,/home/dianwen/SIIM_ACR/train/images/1024/dicom/1.2.276.0.7230010.3.1.4.8323329.333.1517875162.422915.png,/home/dianwen/SIIM_ACR/train/images/1024/mask/1.2.276.0.7230010.3.1.4.8323329.333.1517875162.422915.png,0.0,0.0,873,886
1.2.276.0.7230010.3.1.4.8323329.334.1517875162.431427.png,426797,{},1,0,"{""name"":""rect"",""x"":87,""y"":65,""width"":756,""height"":768}",{},768,rect,756,87,65,/home/dianwen/SIIM_ACR/train/images/1024/dicom/1.2.276.0.7230010.3.1.4.8323329.334.1517875162.431427.png,/home/dianwen/SIIM_ACR/train/images/1024/mask/1.2.276.0.7230010.3.1.4.8323329.334.1517875162.431427.png,0.001873016357421875,1.0,833,843
1.2.276.0.7230010.3.1.4.8323329.335.1517875162.443624.png,381182,{},1,0,"{""name"":""rect"",""x"":187,""y"":143,""width"":662,""height"":633}",{},633,rect,662,187,143,/home/dianwen/SIIM_ACR/train/images/1024/dicom/1.2.276.0.7230010.3.1.4.8323329.335.1517875162.443624.png,/home/dianwen/SIIM_ACR/train/images/1024/mask/1.2.276.0.7230010.3.1.4.8323329.335.1517875162.443624.png,0.0,0.0,776,849
1.2.276.0.7230010.3.1.4.8323329.336.1517875162.443786.png,396554,{},1,0,"{""name"":""rect"",""x"":91,""y"":66,""width"":885,""height"":795}",{},795,rect,885,91,66,/home/dianwen/SIIM_ACR/train/images/1024/dicom/1.2.276.0.7230010.3.1.4.8323329.336.1517875162.443786.png,/home/dianwen/SIIM_ACR/train/images/1024/mask/1.2.276.0.7230010.3.1.4.8323329.336.1517875162.443786.png,0.0,0.0,861,976
1.2.276.0.7230010.3.1.4.8323329.337.1517875162.449985.png,421523,{},1,0,"{""name"":""rect"",""x"":133,""y"":238,""width"":869,""height"":783}",{},783,rect,869,133,238,/home/dianwen/SIIM_ACR/train/images/1024/dicom/1.2.276.0.7230010.3.1.4.8323329.337.1517875162.449985.png,/home/dianwen/SIIM_ACR/train/images/1024/mask/1.2.276.0.7230010.3.1.4.8323329.337.1517875162.449985.png,0.0,0.0,1021,1002
1.2.276.0.7230010.3.1.4.8323329.338.1517875162.455978.png,393454,{},1,0,"{""name"":""rect"",""x"":189,""y"":16,""width"":710,""height"":691}",{},691,rect,710,189,16,/home/dianwen/SIIM_ACR/train/images/1024/dicom/1.2.276.0.7230010.3.1.4.8323329.338.1517875162.455978.png,/home/dianwen/SIIM_ACR/train/images/1024/mask/1.2.276.0.7230010.3.1.4.8323329.338.1517875162.455978.png,5.245208740234375e-05,1.0,707,899
1.2.276.0.7230010.3.1.4.8323329.339.1517875162.471556.png,344701,{},1,0,"{""name"":""rect"",""x"":82,""y"":130,""width"":873,""height"":580}",{},580,rect,873,82,130,/home/dianwen/SIIM_ACR/train/images/1024/dicom/1.2.276.0.7230010.3.1.4.8323329.339.1517875162.471556.png,/home/dianwen/SIIM_ACR/train/images/1024/mask/1.2.276.0.7230010.3.1.4.8323329.339.1517875162.471556.png,0.0,0.0,710,955
1.2.276.0.7230010.3.1.4.8323329.340.1517875162.465768.png,417598,{},1,0,"{""name"":""rect"",""x"":129,""y"":45,""width"":740,""height"":652}",{},652,rect,740,129,45,/home/dianwen/SIIM_ACR/train/images/1024/dicom/1.2.276.0.7230010.3.1.4.8323329.340.1517875162.465768.png,/home/dianwen/SIIM_ACR/train/images/1024/mask/1.2.276.0.7230010.3.1.4.8323329.340.1517875162.465768.png,0.0,0.0,697,869
1.2.276.0.7230010.3.1.4.8323329.341.1517875162.473222.png,378875,{},1,0,"{""name"":""rect"",""x"":114,""y"":76,""width"":831,""height"":811}",{},811,rect,831,114,76,/home/dianwen/SIIM_ACR/train/images/1024/dicom/1.2.276.0.7230010.3.1.4.8323329.341.1517875162.473222.png,/home/dianwen/SIIM_ACR/train/images/1024/mask/1.2.276.0.7230010.3.1.4.8323329.341.1517875162.473222.png,0.0,0.0,887,945
1.2.276.0.7230010.3.1.4.8323329.342.1517875162.476923.png,375822,{},1,0,"{""name"":""rect"",""x"":20,""y"":122,""width"":985,""height"":886}",{},886,rect,985,20,122,/home/dianwen/SIIM_ACR/train/images/1024/dicom/1.2.276.0.7230010.3.1.4.8323329.342.1517875162.476923.png,/home/dianwen/SIIM_ACR/train/images/1024/mask/1.2.276.0.7230010.3.1.4.8323329.342.1517875162.476923.png,0.015735626220703125,1.0,1008,1005
1.2.276.0.7230010.3.1.4.8323329.343.1517875162.487099.png,298354,{},1,0,"{""name"":""rect"",""x"":199,""y"":122,""width"":785,""height"":532}",{},532,rect,785,199,122,/home/dianwen/SIIM_ACR/train/images/1024/dicom/1.2.276.0.7230010.3.1.4.8323329.343.1517875162.487099.png,/home/dianwen/SIIM_ACR/train/images/1024/mask/1.2.276.0.7230010.3.1.4.8323329.343.1517875162.487099.png,0.0,0.0,654,984
1.2.276.0.7230010.3.1.4.8323329.344.1517875162.485361.png,411358,{},1,0,"{""name"":""rect"",""x"":80,""y"":112,""width"":880,""height"":722}",{},722,rect,880,80,112,/home/dianwen/SIIM_ACR/train/images/1024/dicom/1.2.276.0.7230010.3.1.4.8323329.344.1517875162.485361.png,/home/dianwen/SIIM_ACR/train/images/1024/mask/1.2.276.0.7230010.3.1.4.8323329.344.1517875162.485361.png,0.0,0.0,834,960
1.2.276.0.7230010.3.1.4.8323329.345.1517875162.488131.png,443328,{},1,0,"{""name"":""rect"",""x"":93,""y"":50,""width"":888,""height"":845}",{},845,rect,888,93,50,/home/dianwen/SIIM_ACR/train/images/1024/dicom/1.2.276.0.7230010.3.1.4.8323329.345.1517875162.488131.png,/home/dianwen/SIIM_ACR/train/images/1024/mask/1.2.276.0.7230010.3.1.4.8323329.345.1517875162.488131.png,0.0,0.0,895,981
1.2.276.0.7230010.3.1.4.8323329.346.1517875162.490759.png,312364,{},1,0,"{""name"":""rect"",""x"":145,""y"":200,""width"":724,""height"":663}",{},663,rect,724,145,200,/home/dianwen/SIIM_ACR/train/images/1024/dicom/1.2.276.0.7230010.3.1.4.8323329.346.1517875162.490759.png,/home/dianwen/SIIM_ACR/train/images/1024/mask/1.2.276.0.7230010.3.1.4.8323329.346.1517875162.490759.png,0.0,0.0,863,869
1.2.276.0.7230010.3.1.4.8323329.347.1517875162.506017.png,399250,{},1,0,"{""name"":""rect"",""x"":138,""y"":82,""width"":792,""height"":937}",{},937,rect,792,138,82,/home/dianwen/SIIM_ACR/train/images/1024/dicom/1.2.276.0.7230010.3.1.4.8323329.347.1517875162.506017.png,/home/dianwen/SIIM_ACR/train/images/1024/mask/1.2.276.0.7230010.3.1.4.8323329.347.1517875162.506017.png,0.0,0.0,1019,930
1.2.276.0.7230010.3.1.4.8323329.348.1517875162.509428.png,348639,{},1,0,"{""name"":""rect"",""x"":3,""y"":87,""width"":915,""height"":723}",{},723,rect,915,3,87,/home/dianwen/SIIM_ACR/train/images/1024/dicom/1.2.276.0.7230010.3.1.4.8323329.348.1517875162.509428.png,/home/dianwen/SIIM_ACR/train/images/1024/mask/1.2.276.0.7230010.3.1.4.8323329.348.1517875162.509428.png,0.0,0.0,810,918
1.2.276.0.7230010.3.1.4.8323329.349.1517875162.510499.png,375450,{},1,0,"{""name"":""rect"",""x"":138,""y"":10,""width"":857,""height"":812}",{},812,rect,857,138,10,/home/dianwen/SIIM_ACR/train/images/1024/dicom/1.2.276.0.7230010.3.1.4.8323329.349.1517875162.510499.png,/home/dianwen/SIIM_ACR/train/images/1024/mask/1.2.276.0.7230010.3.1.4.8323329.349.1517875162.510499.png,0.0,0.0,822,995
1.2.276.0.7230010.3.1.4.8323329.350.1517875162.508837.png,410229,{},1,0,"{""name"":""rect"",""x"":168,""y"":52,""width"":663,""height"":666}",{},666,rect,663,168,52,/home/dianwen/SIIM_ACR/train/images/1024/dicom/1.2.276.0.7230010.3.1.4.8323329.350.1517875162.508837.png,/home/dianwen/SIIM_ACR/train/images/1024/mask/1.2.276.0.7230010.3.1.4.8323329.350.1517875162.508837.png,0.0,0.0,718,831
1.2.276.0.7230010.3.1.4.8323329.351.1517875162.512468.png,401944,{},1,0,"{""name"":""rect"",""x"":44,""y"":44,""width"":884,""height"":759}",{},759,rect,884,44,44,/home/dianwen/SIIM_ACR/train/images/1024/dicom/1.2.276.0.7230010.3.1.4.8323329.351.1517875162.512468.png,/home/dianwen/SIIM_ACR/train/images/1024/mask/1.2.276.0.7230010.3.1.4.8323329.351.1517875162.512468.png,0.0,0.0,803,928
1.2.276.0.7230010.3.1.4.8323329.352.1517875162.525205.png,408143,{},1,0,"{""name"":""rect"",""x"":182,""y"":165,""width"":752,""height"":843}",{},843,rect,752,182,165,/home/dianwen/SIIM_ACR/train/images/1024/dicom/1.2.276.0.7230010.3.1.4.8323329.352.1517875162.525205.png,/home/dianwen/SIIM_ACR/train/images/1024/mask/1.2.276.0.7230010.3.1.4.8323329.352.1517875162.525205.png,0.05727958679199219,1.0,1008,934
1.2.276.0.7230010.3.1.4.8323329.353.1517875162.525916.png,400457,{},1,0,"{""name"":""rect"",""x"":202,""y"":25,""width"":689,""height"":852}",{},852,rect,689,202,25,/home/dianwen/SIIM_ACR/train/images/1024/dicom/1.2.276.0.7230010.3.1.4.8323329.353.1517875162.525916.png,/home/dianwen/SIIM_ACR/train/images/1024/mask/1.2.276.0.7230010.3.1.4.8323329.353.1517875162.525916.png,0.008778572082519531,1.0,877,891
1.2.276.0.7230010.3.1.4.8323329.354.1517875162.528556.png,434123,{},1,0,"{""name"":""rect"",""x"":138,""y"":174,""width"":788,""height"":740}",{},740,rect,788,138,174,/home/dianwen/SIIM_ACR/train/images/1024/dicom/1.2.276.0.7230010.3.1.4.8323329.354.1517875162.528556.png,/home/dianwen/SIIM_ACR/train/images/1024/mask/1.2.276.0.7230010.3.1.4.8323329.354.1517875162.528556.png,0.037077903747558594,1.0,914,926
1.2.276.0.7230010.3.1.4.8323329.355.1517875162.531219.png,343288,{},1,0,"{""name"":""rect"",""x"":119,""y"":205,""width"":739,""height"":515}",{},515,rect,739,119,205,/home/dianwen/SIIM_ACR/train/images/1024/dicom/1.2.276.0.7230010.3.1.4.8323329.355.1517875162.531219.png,/home/dianwen/SIIM_ACR/train/images/1024/mask/1.2.276.0.7230010.3.1.4.8323329.355.1517875162.531219.png,0.0,0.0,720,858
1.2.276.0.7230010.3.1.4.8323329.356.1517875162.533140.png,312795,{},1,0,"{""name"":""rect"",""x"":198,""y"":25,""width"":758,""height"":863}",{},863,rect,758,198,25,/home/dianwen/SIIM_ACR/train/images/1024/dicom/1.2.276.0.7230010.3.1.4.8323329.356.1517875162.533140.png,/home/dianwen/SIIM_ACR/train/images/1024/mask/1.2.276.0.7230010.3.1.4.8323329.356.1517875162.533140.png,0.0,0.0,888,956
1.2.276.0.7230010.3.1.4.8323329.357.1517875162.533920.png,400560,{},1,0,"{""name"":""rect"",""x"":63,""y"":69,""width"":903,""height"":952}",{},952,rect,903,63,69,/home/dianwen/SIIM_ACR/train/images/1024/dicom/1.2.276.0.7230010.3.1.4.8323329.357.1517875162.533920.png,/home/dianwen/SIIM_ACR/train/images/1024/mask/1.2.276.0.7230010.3.1.4.8323329.357.1517875162.533920.png,0.0,0.0,1021,966
1.2.276.0.7230010.3.1.4.8323329.358.1517875162.548633.png,368178,{},1,0,"{""name"":""rect"",""x"":101,""y"":68,""width"":769,""height"":855}",{},855,rect,769,101,68,/home/dianwen/SIIM_ACR/train/images/1024/dicom/1.2.276.0.7230010.3.1.4.8323329.358.1517875162.548633.png,/home/dianwen/SIIM_ACR/train/images/1024/mask/1.2.276.0.7230010.3.1.4.8323329.358.1517875162.548633.png,0.0,0.0,923,870
1.2.276.0.7230010.3.1.4.8323329.359.1517875162.552256.png,370503,{},1,0,"{""name"":""rect"",""x"":74,""y"":9,""width"":837,""height"":688}",{},688,rect,837,74,9,/home/dianwen/SIIM_ACR/train/images/1024/dicom/1.2.276.0.7230010.3.1.4.8323329.359.1517875162.552256.png,/home/dianwen/SIIM_ACR/train/images/1024/mask/1.2.276.0.7230010.3.1.4.8323329.359.1517875162.552256.png,0.006498336791992188,1.0,697,911
1.2.276.0.7230010.3.1.4.8323329.360.1517875162.553900.png,461131,{},1,0,"{""name"":""rect"",""x"":73,""y"":121,""width"":816,""height"":877}",{},877,rect,816,73,121,/home/dianwen/SIIM_ACR/train/images/1024/dicom/1.2.276.0.7230010.3.1.4.8323329.360.1517875162.553900.png,/home/dianwen/SIIM_ACR/train/images/1024/mask/1.2.276.0.7230010.3.1.4.8323329.360.1517875162.553900.png,0.01818370819091797,1.0,998,889
1.2.276.0.7230010.3.1.4.8323329.361.1517875162.554473.png,328808,{},1,0,"{""name"":""rect"",""x"":161,""y"":411,""width"":792,""height"":603}",{},603,rect,792,161,411,/home/dianwen/SIIM_ACR/train/images/1024/dicom/1.2.276.0.7230010.3.1.4.8323329.361.1517875162.554473.png,/home/dianwen/SIIM_ACR/train/images/1024/mask/1.2.276.0.7230010.3.1.4.8323329.361.1517875162.554473.png,0.0,0.0,1014,953
1.2.276.0.7230010.3.1.4.8323329.362.1517875162.555008.png,397300,{},1,0,"{""name"":""rect"",""x"":230,""y"":103,""width"":668,""height"":862}",{},862,rect,668,230,103,/home/dianwen/SIIM_ACR/train/images/1024/dicom/1.2.276.0.7230010.3.1.4.8323329.362.1517875162.555008.png,/home/dianwen/SIIM_ACR/train/images/1024/mask/1.2.276.0.7230010.3.1.4.8323329.362.1517875162.555008.png,0.0,0.0,965,898
1.2.276.0.7230010.3.1.4.8323329.364.1517875162.570994.png,349444,{},1,0,"{""name"":""rect"",""x"":62,""y"":125,""width"":828,""height"":850}",{},850,rect,828,62,125,/home/dianwen/SIIM_ACR/train/images/1024/dicom/1.2.276.0.7230010.3.1.4.8323329.364.1517875162.570994.png,/home/dianwen/SIIM_ACR/train/images/1024/mask/1.2.276.0.7230010.3.1.4.8323329.364.1517875162.570994.png,0.0,0.0,975,890
1.2.276.0.7230010.3.1.4.8323329.365.1517875162.574178.png,323796,{},1,0,"{""name"":""rect"",""x"":162,""y"":96,""width"":673,""height"":905}",{},905,rect,673,162,96,/home/dianwen/SIIM_ACR/train/images/1024/dicom/1.2.276.0.7230010.3.1.4.8323329.365.1517875162.574178.png,/home/dianwen/SIIM_ACR/train/images/1024/mask/1.2.276.0.7230010.3.1.4.8323329.365.1517875162.574178.png,0.0,0.0,1001,835
1.2.276.0.7230010.3.1.4.8323329.366.1517875162.573451.png,436117,{},1,0,"{""name"":""rect"",""x"":128,""y"":101,""width"":788,""height"":793}",{},793,rect,788,128,101,/home/dianwen/SIIM_ACR/train/images/1024/dicom/1.2.276.0.7230010.3.1.4.8323329.366.1517875162.573451.png,/home/dianwen/SIIM_ACR/train/images/1024/mask/1.2.276.0.7230010.3.1.4.8323329.366.1517875162.573451.png,0.0,0.0,894,916
1.2.276.0.7230010.3.1.4.8323329.367.1517875162.573432.png,449411,{},1,0,"{""name"":""rect"",""x"":16,""y"":96,""width"":995,""height"":888}",{},888,rect,995,16,96,/home/dianwen/SIIM_ACR/train/images/1024/dicom/1.2.276.0.7230010.3.1.4.8323329.367.1517875162.573432.png,/home/dianwen/SIIM_ACR/train/images/1024/mask/1.2.276.0.7230010.3.1.4.8323329.367.1517875162.573432.png,0.01575183868408203,1.0,984,1011
1.2.276.0.7230010.3.1.4.8323329.368.1517875162.584967.png,425943,{},1,0,"{""name"":""rect"",""x"":140,""y"":32,""width"":782,""height"":786}",{},786,rect,782,140,32,/home/dianwen/SIIM_ACR/train/images/1024/dicom/1.2.276.0.7230010.3.1.4.8323329.368.1517875162.584967.png,/home/dianwen/SIIM_ACR/train/images/1024/mask/1.2.276.0.7230010.3.1.4.8323329.368.1517875162.584967.png,0.00984954833984375,1.0,818,922
1.2.276.0.7230010.3.1.4.8323329.369.1517875162.590965.png,408832,{},1,0,"{""name"":""rect"",""x"":131,""y"":87,""width"":727,""height"":770}",{},770,rect,727,131,87,/home/dianwen/SIIM_ACR/train/images/1024/dicom/1.2.276.0.7230010.3.1.4.8323329.369.1517875162.590965.png,/home/dianwen/SIIM_ACR/train/images/1024/mask/1.2.276.0.7230010.3.1.4.8323329.369.1517875162.590965.png,0.0,0.0,857,858
1.2.276.0.7230010.3.1.4.8323329.370.1517875162.592466.png,323153,{},1,0,"{""name"":""rect"",""x"":149,""y"":56,""width"":767,""height"":754}",{},754,rect,767,149,56,/home/dianwen/SIIM_ACR/train/images/1024/dicom/1.2.276.0.7230010.3.1.4.8323329.370.1517875162.592466.png,/home/dianwen/SIIM_ACR/train/images/1024/mask/1.2.276.0.7230010.3.1.4.8323329.370.1517875162.592466.png,0.0,0.0,810,916
1.2.276.0.7230010.3.1.4.8323329.371.1517875162.592396.png,452613,{},1,0,"{""name"":""rect"",""x"":10,""y"":54,""width"":953,""height"":666}",{},666,rect,953,10,54,/home/dianwen/SIIM_ACR/train/images/1024/dicom/1.2.276.0.7230010.3.1.4.8323329.371.1517875162.592396.png,/home/dianwen/SIIM_ACR/train/images/1024/mask/1.2.276.0.7230010.3.1.4.8323329.371.1517875162.592396.png,0.0,0.0,720,963
1.2.276.0.7230010.3.1.4.8323329.372.1517875162.608228.png,466282,{},1,0,"{""name"":""rect"",""x"":73,""y"":59,""width"":880,""height"":681}",{},681,rect,880,73,59,/home/dianwen/SIIM_ACR/train/images/1024/dicom/1.2.276.0.7230010.3.1.4.8323329.372.1517875162.608228.png,/home/dianwen/SIIM_ACR/train/images/1024/mask/1.2.276.0.7230010.3.1.4.8323329.372.1517875162.608228.png,0.030196581035852432,1.0,740,953
1.2.276.0.7230010.3.1.4.8323329.373.1517875162.608023.png,371404,{},1,0,"{""name"":""rect"",""x"":31,""y"":66,""width"":868,""height"":956}",{},956,rect,868,31,66,/home/dianwen/SIIM_ACR/train/images/1024/dicom/1.2.276.0.7230010.3.1.4.8323329.373.1517875162.608023.png,/home/dianwen/SIIM_ACR/train/images/1024/mask/1.2.276.0.7230010.3.1.4.8323329.373.1517875162.608023.png,0.0,0.0,1022,899
1.2.276.0.7230010.3.1.4.8323329.374.1517875162.614663.png,406764,{},1,0,"{""name"":""rect"",""x"":198,""y"":72,""width"":739,""height"":588}",{},588,rect,739,198,72,/home/dianwen/SIIM_ACR/train/images/1024/dicom/1.2.276.0.7230010.3.1.4.8323329.374.1517875162.614663.png,/home/dianwen/SIIM_ACR/train/images/1024/mask/1.2.276.0.7230010.3.1.4.8323329.374.1517875162.614663.png,0.0,0.0,660,937
1.2.276.0.7230010.3.1.4.8323329.375.1517875162.621322.png,437057,{},1,0,"{""name"":""rect"",""x"":51,""y"":84,""width"":913,""height"":816}",{},816,rect,913,51,84,/home/dianwen/SIIM_ACR/train/images/1024/dicom/1.2.276.0.7230010.3.1.4.8323329.375.1517875162.621322.png,/home/dianwen/SIIM_ACR/train/images/1024/mask/1.2.276.0.7230010.3.1.4.8323329.375.1517875162.621322.png,0.0,0.0,900,964
1.2.276.0.7230010.3.1.4.8323329.376.1517875162.629466.png,400856,{},1,0,"{""name"":""rect"",""x"":113,""y"":57,""width"":701,""height"":641}",{},641,rect,701,113,57,/home/dianwen/SIIM_ACR/train/images/1024/dicom/1.2.276.0.7230010.3.1.4.8323329.376.1517875162.629466.png,/home/dianwen/SIIM_ACR/train/images/1024/mask/1.2.276.0.7230010.3.1.4.8323329.376.1517875162.629466.png,0.0,0.0,698,814
1.2.276.0.7230010.3.1.4.8323329.377.1517875162.629482.png,370474,{},1,0,"{""name"":""rect"",""x"":194,""y"":51,""width"":692,""height"":758}",{},758,rect,692,194,51,/home/dianwen/SIIM_ACR/train/images/1024/dicom/1.2.276.0.7230010.3.1.4.8323329.377.1517875162.629482.png,/home/dianwen/SIIM_ACR/train/images/1024/mask/1.2.276.0.7230010.3.1.4.8323329.377.1517875162.629482.png,0.0,0.0,809,886
1.2.276.0.7230010.3.1.4.8323329.378.1517875162.653925.png,416820,{},1,0,"{""name"":""rect"",""x"":212,""y"":34,""width"":734,""height"":824}",{},824,rect,734,212,34,/home/dianwen/SIIM_ACR/train/images/1024/dicom/1.2.276.0.7230010.3.1.4.8323329.378.1517875162.653925.png,/home/dianwen/SIIM_ACR/train/images/1024/mask/1.2.276.0.7230010.3.1.4.8323329.378.1517875162.653925.png,0.00650787353515625,1.0,858,946
1.2.276.0.7230010.3.1.4.8323329.379.1517875162.650632.png,432210,{},1,0,"{""name"":""rect"",""x"":41,""y"":94,""width"":868,""height"":728}",{},728,rect,868,41,94,/home/dianwen/SIIM_ACR/train/images/1024/dicom/1.2.276.0.7230010.3.1.4.8323329.379.1517875162.650632.png,/home/dianwen/SIIM_ACR/train/images/1024/mask/1.2.276.0.7230010.3.1.4.8323329.379.1517875162.650632.png,0.0,0.0,822,909
1.2.276.0.7230010.3.1.4.8323329.380.1517875162.650632.png,373945,{},1,0,"{""name"":""rect"",""x"":116,""y"":75,""width"":790,""height"":742}",{},742,rect,790,116,75,/home/dianwen/SIIM_ACR/train/images/1024/dicom/1.2.276.0.7230010.3.1.4.8323329.380.1517875162.650632.png,/home/dianwen/SIIM_ACR/train/images/1024/mask/1.2.276.0.7230010.3.1.4.8323329.380.1517875162.650632.png,0.0,0.0,817,906
1.2.276.0.7230010.3.1.4.8323329.381.1517875162.653343.png,393301,{},1,0,"{""name"":""rect"",""x"":137,""y"":147,""width"":780,""height"":705}",{},705,rect,780,137,147,/home/dianwen/SIIM_ACR/train/images/1024/dicom/1.2.276.0.7230010.3.1.4.8323329.381.1517875162.653343.png,/home/dianwen/SIIM_ACR/train/images/1024/mask/1.2.276.0.7230010.3.1.4.8323329.381.1517875162.653343.png,0.0,0.0,852,917
1.2.276.0.7230010.3.1.4.8323329.382.1517875162.655491.png,354324,{},1,0,"{""name"":""rect"",""x"":88,""y"":151,""width"":925,""height"":782}",{},782,rect,925,88,151,/home/dianwen/SIIM_ACR/train/images/1024/dicom/1.2.276.0.7230010.3.1.4.8323329.382.1517875162.655491.png,/home/dianwen/SIIM_ACR/train/images/1024/mask/1.2.276.0.7230010.3.1.4.8323329.382.1517875162.655491.png,0.0,0.0,933,1013
1.2.276.0.7230010.3.1.4.8323329.383.1517875162.669156.png,426014,{},1,0,"{""name"":""rect"",""x"":121,""y"":100,""width"":819,""height"":761}",{},761,rect,819,121,100,/home/dianwen/SIIM_ACR/train/images/1024/dicom/1.2.276.0.7230010.3.1.4.8323329.383.1517875162.669156.png,/home/dianwen/SIIM_ACR/train/images/1024/mask/1.2.276.0.7230010.3.1.4.8323329.383.1517875162.669156.png,0.0,0.0,861,940
1.2.276.0.7230010.3.1.4.8323329.384.1517875162.674411.png,454870,{},1,0,"{""name"":""rect"",""x"":27,""y"":32,""width"":933,""height"":711}",{},711,rect,933,27,32,/home/dianwen/SIIM_ACR/train/images/1024/dicom/1.2.276.0.7230010.3.1.4.8323329.384.1517875162.674411.png,/home/dianwen/SIIM_ACR/train/images/1024/mask/1.2.276.0.7230010.3.1.4.8323329.384.1517875162.674411.png,0.0,0.0,743,960
1.2.276.0.7230010.3.1.4.8323329.385.1517875162.689893.png,364978,{},1,0,"{""name"":""rect"",""x"":144,""y"":43,""width"":791,""height"":939}",{},939,rect,791,144,43,/home/dianwen/SIIM_ACR/train/images/1024/dicom/1.2.276.0.7230010.3.1.4.8323329.385.1517875162.689893.png,/home/dianwen/SIIM_ACR/train/images/1024/mask/1.2.276.0.7230010.3.1.4.8323329.385.1517875162.689893.png,0.0,0.0,982,935
1.2.276.0.7230010.3.1.4.8323329.386.1517875162.694420.png,347598,{},1,0,"{""name"":""rect"",""x"":170,""y"":79,""width"":786,""height"":749}",{},749,rect,786,170,79,/home/dianwen/SIIM_ACR/train/images/1024/dicom/1.2.276.0.7230010.3.1.4.8323329.386.1517875162.694420.png,/home/dianwen/SIIM_ACR/train/images/1024/mask/1.2.276.0.7230010.3.1.4.8323329.386.1517875162.694420.png,0.0,0.0,828,956
1.2.276.0.7230010.3.1.4.8323329.387.1517875162.707372.png,315897,{},1,0,"{""name"":""rect"",""x"":202,""y"":151,""width"":743,""height"":662}",{},662,rect,743,202,151,/home/dianwen/SIIM_ACR/train/images/1024/dicom/1.2.276.0.7230010.3.1.4.8323329.387.1517875162.707372.png,/home/dianwen/SIIM_ACR/train/images/1024/mask/1.2.276.0.7230010.3.1.4.8323329.387.1517875162.707372.png,0.0,0.0,813,945
1.2.276.0.7230010.3.1.4.8323329.388.1517875162.713279.png,615653,{},1,0,"{""name"":""rect"",""x"":2,""y"":16,""width"":797,""height"":870}",{},870,rect,797,2,16,/home/dianwen/SIIM_ACR/train/images/1024/dicom/1.2.276.0.7230010.3.1.4.8323329.388.1517875162.713279.png,/home/dianwen/SIIM_ACR/train/images/1024/mask/1.2.276.0.7230010.3.1.4.8323329.388.1517875162.713279.png,0.0,0.0,886,799
1.2.276.0.7230010.3.1.4.8323329.389.1517875162.733243.png,338323,{},1,0,"{""name"":""rect"",""x"":138,""y"":131,""width"":748,""height"":884}",{},884,rect,748,138,131,/home/dianwen/SIIM_ACR/train/images/1024/dicom/1.2.276.0.7230010.3.1.4.8323329.389.1517875162.733243.png,/home/dianwen/SIIM_ACR/train/images/1024/mask/1.2.276.0.7230010.3.1.4.8323329.389.1517875162.733243.png,0.0,0.0,1015,886
1.2.276.0.7230010.3.1.4.8323329.390.1517875162.725254.png,406632,{},1,0,"{""name"":""rect"",""x"":172,""y"":106,""width"":711,""height"":558}",{},558,rect,711,172,106,/home/dianwen/SIIM_ACR/train/images/1024/dicom/1.2.276.0.7230010.3.1.4.8323329.390.1517875162.725254.png,/home/dianwen/SIIM_ACR/train/images/1024/mask/1.2.276.0.7230010.3.1.4.8323329.390.1517875162.725254.png,0.0,0.0,664,883
1.2.276.0.7230010.3.1.4.8323329.391.1517875162.734705.png,383925,{},1,0,"{""name"":""rect"",""x"":78,""y"":106,""width"":720,""height"":722}",{},722,rect,720,78,106,/home/dianwen/SIIM_ACR/train/images/1024/dicom/1.2.276.0.7230010.3.1.4.8323329.391.1517875162.734705.png,/home/dianwen/SIIM_ACR/train/images/1024/mask/1.2.276.0.7230010.3.1.4.8323329.391.1517875162.734705.png,0.0,0.0,828,798
1.2.276.0.7230010.3.1.4.8323329.392.1517875162.735831.png,450521,{},1,0,"{""name"":""rect"",""x"":112,""y"":109,""width"":802,""height"":669}",{},669,rect,802,112,109,/home/dianwen/SIIM_ACR/train/images/1024/dicom/1.2.276.0.7230010.3.1.4.8323329.392.1517875162.735831.png,/home/dianwen/SIIM_ACR/train/images/1024/mask/1.2.276.0.7230010.3.1.4.8323329.392.1517875162.735831.png,0.009613990783691406,1.0,778,914
1.2.276.0.7230010.3.1.4.8323329.393.1517875162.769413.png,437258,{},1,0,"{""name"":""rect"",""x"":56,""y"":80,""width"":931,""height"":676}",{},676,rect,931,56,80,/home/dianwen/SIIM_ACR/train/images/1024/dicom/1.2.276.0.7230010.3.1.4.8323329.393.1517875162.769413.png,/home/dianwen/SIIM_ACR/train/images/1024/mask/1.2.276.0.7230010.3.1.4.8323329.393.1517875162.769413.png,0.0,0.0,756,987
1.2.276.0.7230010.3.1.4.8323329.394.1517875162.744284.png,418294,{},1,0,"{""name"":""rect"",""x"":118,""y"":117,""width"":763,""height"":830}",{},830,rect,763,118,117,/home/dianwen/SIIM_ACR/train/images/1024/dicom/1.2.276.0.7230010.3.1.4.8323329.394.1517875162.744284.png,/home/dianwen/SIIM_ACR/train/images/1024/mask/1.2.276.0.7230010.3.1.4.8323329.394.1517875162.744284.png,0.0,0.0,947,881
1.2.276.0.7230010.3.1.4.8323329.395.1517875162.771343.png,293752,{},1,0,"{""name"":""rect"",""x"":231,""y"":221,""width"":783,""height"":799}",{},799,rect,783,231,221,/home/dianwen/SIIM_ACR/train/images/1024/dicom/1.2.276.0.7230010.3.1.4.8323329.395.1517875162.771343.png,/home/dianwen/SIIM_ACR/train/images/1024/mask/1.2.276.0.7230010.3.1.4.8323329.395.1517875162.771343.png,0.0,0.0,1020,1014
1.2.276.0.7230010.3.1.4.8323329.396.1517875162.761721.png,355614,{},1,0,"{""name"":""rect"",""x"":150,""y"":237,""width"":712,""height"":785}",{},785,rect,712,150,237,/home/dianwen/SIIM_ACR/train/images/1024/dicom/1.2.276.0.7230010.3.1.4.8323329.396.1517875162.761721.png,/home/dianwen/SIIM_ACR/train/images/1024/mask/1.2.276.0.7230010.3.1.4.8323329.396.1517875162.761721.png,0.0,0.0,1022,862
1.2.276.0.7230010.3.1.4.8323329.397.1517875162.763470.png,427123,{},1,0,"{""name"":""rect"",""x"":8,""y"":144,""width"":927,""height"":725}",{},725,rect,927,8,144,/home/dianwen/SIIM_ACR/train/images/1024/dicom/1.2.276.0.7230010.3.1.4.8323329.397.1517875162.763470.png,/home/dianwen/SIIM_ACR/train/images/1024/mask/1.2.276.0.7230010.3.1.4.8323329.397.1517875162.763470.png,0.0,0.0,869,935
1.2.276.0.7230010.3.1.4.8323329.398.1517875162.768699.png,406019,{},1,0,"{""name"":""rect"",""x"":108,""y"":78,""width"":867,""height"":902}",{},902,rect,867,108,78,/home/dianwen/SIIM_ACR/train/images/1024/dicom/1.2.276.0.7230010.3.1.4.8323329.398.1517875162.768699.png,/home/dianwen/SIIM_ACR/train/images/1024/mask/1.2.276.0.7230010.3.1.4.8323329.398.1517875162.768699.png,0.0,0.0,980,975
1.2.276.0.7230010.3.1.4.8323329.399.1517875162.771217.png,396238,{},1,0,"{""name"":""rect"",""x"":135,""y"":113,""width"":685,""height"":748}",{},748,rect,685,135,113,/home/dianwen/SIIM_ACR/train/images/1024/dicom/1.2.276.0.7230010.3.1.4.8323329.399.1517875162.771217.png,/home/dianwen/SIIM_ACR/train/images/1024/mask/1.2.276.0.7230010.3.1.4.8323329.399.1517875162.771217.png,0.0,0.0,861,820
1.2.276.0.7230010.3.1.4.8323329.400.1517875162.793632.png,437040,{},1,0,"{""name"":""rect"",""x"":79,""y"":59,""width"":860,""height"":707}",{},707,rect,860,79,59,/home/dianwen/SIIM_ACR/train/images/1024/dicom/1.2.276.0.7230010.3.1.4.8323329.400.1517875162.793632.png,/home/dianwen/SIIM_ACR/train/images/1024/mask/1.2.276.0.7230010.3.1.4.8323329.400.1517875162.793632.png,0.0,0.0,766,939
1.2.276.0.7230010.3.1.4.8323329.401.1517875162.786368.png,448280,{},1,0,"{""name"":""rect"",""x"":153,""y"":28,""width"":720,""height"":714}",{},714,rect,720,153,28,/home/dianwen/SIIM_ACR/train/images/1024/dicom/1.2.276.0.7230010.3.1.4.8323329.401.1517875162.786368.png,/home/dianwen/SIIM_ACR/train/images/1024/mask/1.2.276.0.7230010.3.1.4.8323329.401.1517875162.786368.png,0.0,0.0,742,873
1.2.276.0.7230010.3.1.4.8323329.402.1517875162.796449.png,416012,{},1,0,"{""name"":""rect"",""x"":126,""y"":138,""width"":814,""height"":776}",{},776,rect,814,126,138,/home/dianwen/SIIM_ACR/train/images/1024/dicom/1.2.276.0.7230010.3.1.4.8323329.402.1517875162.796449.png,/home/dianwen/SIIM_ACR/train/images/1024/mask/1.2.276.0.7230010.3.1.4.8323329.402.1517875162.796449.png,0.0,0.0,914,940
1.2.276.0.7230010.3.1.4.8323329.403.1517875162.798239.png,414268,{},1,0,"{""name"":""rect"",""x"":35,""y"":170,""width"":761,""height"":760}",{},760,rect,761,35,170,/home/dianwen/SIIM_ACR/train/images/1024/dicom/1.2.276.0.7230010.3.1.4.8323329.403.1517875162.798239.png,/home/dianwen/SIIM_ACR/train/images/1024/mask/1.2.276.0.7230010.3.1.4.8323329.403.1517875162.798239.png,0.0,0.0,930,796
1.2.276.0.7230010.3.1.4.8323329.404.1517875162.798158.png,433295,{},1,0,"{""name"":""rect"",""x"":160,""y"":45,""width"":829,""height"":922}",{},922,rect,829,160,45,/home/dianwen/SIIM_ACR/train/images/1024/dicom/1.2.276.0.7230010.3.1.4.8323329.404.1517875162.798158.png,/home/dianwen/SIIM_ACR/train/images/1024/mask/1.2.276.0.7230010.3.1.4.8323329.404.1517875162.798158.png,0.0,0.0,967,989
1.2.276.0.7230010.3.1.4.8323329.405.1517875162.805616.png,436903,{},1,0,"{""name"":""rect"",""x"":51,""y"":15,""width"":835,""height"":601}",{},601,rect,835,51,15,/home/dianwen/SIIM_ACR/train/images/1024/dicom/1.2.276.0.7230010.3.1.4.8323329.405.1517875162.805616.png,/home/dianwen/SIIM_ACR/train/images/1024/mask/1.2.276.0.7230010.3.1.4.8323329.405.1517875162.805616.png,0.0,0.0,616,886
1.2.276.0.7230010.3.1.4.8323329.406.1517875162.818172.png,455009,{},1,0,"{""name"":""rect"",""x"":18,""y"":72,""width"":924,""height"":864}",{},864,rect,924,18,72,/home/dianwen/SIIM_ACR/train/images/1024/dicom/1.2.276.0.7230010.3.1.4.8323329.406.1517875162.818172.png,/home/dianwen/SIIM_ACR/train/images/1024/mask/1.2.276.0.7230010.3.1.4.8323329.406.1517875162.818172.png,0.017459960654377937,1.0,936,942
1.2.276.0.7230010.3.1.4.8323329.407.1517875162.819441.png,420221,{},1,0,"{""name"":""rect"",""x"":154,""y"":160,""width"":809,""height"":735}",{},735,rect,809,154,160,/home/dianwen/SIIM_ACR/train/images/1024/dicom/1.2.276.0.7230010.3.1.4.8323329.407.1517875162.819441.png,/home/dianwen/SIIM_ACR/train/images/1024/mask/1.2.276.0.7230010.3.1.4.8323329.407.1517875162.819441.png,0.0,0.0,895,963
1.2.276.0.7230010.3.1.4.8323329.408.1517875162.820989.png,446967,{},1,0,"{""name"":""rect"",""x"":25,""y"":72,""width"":843,""height"":856}",{},856,rect,843,25,72,/home/dianwen/SIIM_ACR/train/images/1024/dicom/1.2.276.0.7230010.3.1.4.8323329.408.1517875162.820989.png,/home/dianwen/SIIM_ACR/train/images/1024/mask/1.2.276.0.7230010.3.1.4.8323329.408.1517875162.820989.png,0.0,0.0,928,868
1.2.276.0.7230010.3.1.4.8323329.409.1517875162.822490.png,395617,{},1,0,"{""name"":""rect"",""x"":217,""y"":150,""width"":766,""height"":733}",{},733,rect,766,217,150,/home/dianwen/SIIM_ACR/train/images/1024/dicom/1.2.276.0.7230010.3.1.4.8323329.409.1517875162.822490.png,/home/dianwen/SIIM_ACR/train/images/1024/mask/1.2.276.0.7230010.3.1.4.8323329.409.1517875162.822490.png,0.0,0.0,883,983
1.2.276.0.7230010.3.1.4.8323329.410.1517875162.823600.png,373269,{},1,0,"{""name"":""rect"",""x"":33,""y"":128,""width"":910,""height"":835}",{},835,rect,910,33,128,/home/dianwen/SIIM_ACR/train/images/1024/dicom/1.2.276.0.7230010.3.1.4.8323329.410.1517875162.823600.png,/home/dianwen/SIIM_ACR/train/images/1024/mask/1.2.276.0.7230010.3.1.4.8323329.410.1517875162.823600.png,0.0,0.0,963,943
1.2.276.0.7230010.3.1.4.8323329.412.1517875162.829513.png,428277,{},1,0,"{""name"":""rect"",""x"":97,""y"":98,""width"":826,""height"":812}",{},812,rect,826,97,98,/home/dianwen/SIIM_ACR/train/images/1024/dicom/1.2.276.0.7230010.3.1.4.8323329.412.1517875162.829513.png,/home/dianwen/SIIM_ACR/train/images/1024/mask/1.2.276.0.7230010.3.1.4.8323329.412.1517875162.829513.png,0.0,0.0,910,923
1.2.276.0.7230010.3.1.4.8323329.413.1517875162.829730.png,362724,{},1,0,"{""name"":""rect"",""x"":53,""y"":92,""width"":867,""height"":852}",{},852,rect,867,53,92,/home/dianwen/SIIM_ACR/train/images/1024/dicom/1.2.276.0.7230010.3.1.4.8323329.413.1517875162.829730.png,/home/dianwen/SIIM_ACR/train/images/1024/mask/1.2.276.0.7230010.3.1.4.8323329.413.1517875162.829730.png,0.0,0.0,944,920
1.2.276.0.7230010.3.1.4.8323329.414.1517875162.829373.png,419761,{},1,0,"{""name"":""rect"",""x"":98,""y"":52,""width"":791,""height"":724}",{},724,rect,791,98,52,/home/dianwen/SIIM_ACR/train/images/1024/dicom/1.2.276.0.7230010.3.1.4.8323329.414.1517875162.829373.png,/home/dianwen/SIIM_ACR/train/images/1024/mask/1.2.276.0.7230010.3.1.4.8323329.414.1517875162.829373.png,0.0,0.0,776,889
1.2.276.0.7230010.3.1.4.8323329.416.1517875162.844867.png,392030,{},1,0,"{""name"":""rect"",""x"":161,""y"":204,""width"":846,""height"":711}",{},711,rect,846,161,204,/home/dianwen/SIIM_ACR/train/images/1024/dicom/1.2.276.0.7230010.3.1.4.8323329.416.1517875162.844867.png,/home/dianwen/SIIM_ACR/train/images/1024/mask/1.2.276.0.7230010.3.1.4.8323329.416.1517875162.844867.png,0.0,0.0,915,1007
1.2.276.0.7230010.3.1.4.8323329.417.1517875162.845288.png,322251,{},1,0,"{""name"":""rect"",""x"":222,""y"":54,""width"":715,""height"":911}",{},911,rect,715,222,54,/home/dianwen/SIIM_ACR/train/images/1024/dicom/1.2.276.0.7230010.3.1.4.8323329.417.1517875162.845288.png,/home/dianwen/SIIM_ACR/train/images/1024/mask/1.2.276.0.7230010.3.1.4.8323329.417.1517875162.845288.png,0.02190399169921875,1.0,965,937
1.2.276.0.7230010.3.1.4.8323329.418.1517875162.845132.png,419547,{},1,0,"{""name"":""rect"",""x"":148,""y"":154,""width"":748,""height"":698}",{},698,rect,748,148,154,/home/dianwen/SIIM_ACR/train/images/1024/dicom/1.2.276.0.7230010.3.1.4.8323329.418.1517875162.845132.png,/home/dianwen/SIIM_ACR/train/images/1024/mask/1.2.276.0.7230010.3.1.4.8323329.418.1517875162.845132.png,0.0,0.0,852,896
1.2.276.0.7230010.3.1.4.8323329.419.1517875162.852731.png,407450,{},1,0,"{""name"":""rect"",""x"":120,""y"":63,""width"":844,""height"":663}",{},663,rect,844,120,63,/home/dianwen/SIIM_ACR/train/images/1024/dicom/1.2.276.0.7230010.3.1.4.8323329.419.1517875162.852731.png,/home/dianwen/SIIM_ACR/train/images/1024/mask/1.2.276.0.7230010.3.1.4.8323329.419.1517875162.852731.png,0.005759239196777344,1.0,726,964
1.2.276.0.7230010.3.1.4.8323329.421.1517875162.854869.png,332259,{},1,0,"{""name"":""rect"",""x"":100,""y"":122,""width"":776,""height"":673}",{},673,rect,776,100,122,/home/dianwen/SIIM_ACR/train/images/1024/dicom/1.2.276.0.7230010.3.1.4.8323329.421.1517875162.854869.png,/home/dianwen/SIIM_ACR/train/images/1024/mask/1.2.276.0.7230010.3.1.4.8323329.421.1517875162.854869.png,0.0,0.0,795,876
1.2.276.0.7230010.3.1.4.8323329.422.1517875162.855531.png,390010,{},1,0,"{""name"":""rect"",""x"":87,""y"":43,""width"":792,""height"":684}",{},684,rect,792,87,43,/home/dianwen/SIIM_ACR/train/images/1024/dicom/1.2.276.0.7230010.3.1.4.8323329.422.1517875162.855531.png,/home/dianwen/SIIM_ACR/train/images/1024/mask/1.2.276.0.7230010.3.1.4.8323329.422.1517875162.855531.png,0.0038518905639648438,1.0,727,879
1.2.276.0.7230010.3.1.4.8323329.423.1517875162.870092.png,438351,{},1,0,"{""name"":""rect"",""x"":106,""y"":154,""width"":876,""height"":767}",{},767,rect,876,106,154,/home/dianwen/SIIM_ACR/train/images/1024/dicom/1.2.276.0.7230010.3.1.4.8323329.423.1517875162.870092.png,/home/dianwen/SIIM_ACR/train/images/1024/mask/1.2.276.0.7230010.3.1.4.8323329.423.1517875162.870092.png,0.0,0.0,921,982
1.2.276.0.7230010.3.1.4.8323329.424.1517875162.866519.png,414474,{},1,0,"{""name"":""rect"",""x"":50,""y"":67,""width"":946,""height"":802}",{},802,rect,946,50,67,/home/dianwen/SIIM_ACR/train/images/1024/dicom/1.2.276.0.7230010.3.1.4.8323329.424.1517875162.866519.png,/home/dianwen/SIIM_ACR/train/images/1024/mask/1.2.276.0.7230010.3.1.4.8323329.424.1517875162.866519.png,0.0,0.0,869,996
1.2.276.0.7230010.3.1.4.8323329.425.1517875162.876307.png,458594,{},1,0,"{""name"":""rect"",""x"":128,""y"":53,""width"":833,""height"":965}",{},965,rect,833,128,53,/home/dianwen/SIIM_ACR/train/images/1024/dicom/1.2.276.0.7230010.3.1.4.8323329.425.1517875162.876307.png,/home/dianwen/SIIM_ACR/train/images/1024/mask/1.2.276.0.7230010.3.1.4.8323329.425.1517875162.876307.png,0.0,0.0,1018,961
1.2.276.0.7230010.3.1.4.8323329.426.1517875162.877157.png,432329,{},1,0,"{""name"":""rect"",""x"":56,""y"":92,""width"":913,""height"":736}",{},736,rect,913,56,92,/home/dianwen/SIIM_ACR/train/images/1024/dicom/1.2.276.0.7230010.3.1.4.8323329.426.1517875162.877157.png,/home/dianwen/SIIM_ACR/train/images/1024/mask/1.2.276.0.7230010.3.1.4.8323329.426.1517875162.877157.png,0.0,0.0,828,969
1.2.276.0.7230010.3.1.4.8323329.427.1517875162.888913.png,394491,{},1,0,"{""name"":""rect"",""x"":53,""y"":115,""width"":893,""height"":801}",{},801,rect,893,53,115,/home/dianwen/SIIM_ACR/train/images/1024/dicom/1.2.276.0.7230010.3.1.4.8323329.427.1517875162.888913.png,/home/dianwen/SIIM_ACR/train/images/1024/mask/1.2.276.0.7230010.3.1.4.8323329.427.1517875162.888913.png,0.0,0.0,916,946
1.2.276.0.7230010.3.1.4.8323329.428.1517875162.885664.png,387419,{},1,0,"{""name"":""rect"",""x"":36,""y"":114,""width"":898,""height"":702}",{},702,rect,898,36,114,/home/dianwen/SIIM_ACR/train/images/1024/dicom/1.2.276.0.7230010.3.1.4.8323329.428.1517875162.885664.png,/home/dianwen/SIIM_ACR/train/images/1024/mask/1.2.276.0.7230010.3.1.4.8323329.428.1517875162.885664.png,0.0,0.0,816,934
1.2.276.0.7230010.3.1.4.8323329.429.1517875162.899237.png,416007,{},1,0,"{""name"":""rect"",""x"":129,""y"":36,""width"":799,""height"":795}",{},795,rect,799,129,36,/home/dianwen/SIIM_ACR/train/images/1024/dicom/1.2.276.0.7230010.3.1.4.8323329.429.1517875162.899237.png,/home/dianwen/SIIM_ACR/train/images/1024/mask/1.2.276.0.7230010.3.1.4.8323329.429.1517875162.899237.png,0.0,0.0,831,928
1.2.276.0.7230010.3.1.4.8323329.430.1517875162.905786.png,425600,{},1,0,"{""name"":""rect"",""x"":49,""y"":68,""width"":836,""height"":881}",{},881,rect,836,49,68,/home/dianwen/SIIM_ACR/train/images/1024/dicom/1.2.276.0.7230010.3.1.4.8323329.430.1517875162.905786.png,/home/dianwen/SIIM_ACR/train/images/1024/mask/1.2.276.0.7230010.3.1.4.8323329.430.1517875162.905786.png,0.0,0.0,949,885
1.2.276.0.7230010.3.1.4.8323329.431.1517875162.902494.png,390999,{},1,0,"{""name"":""rect"",""x"":134,""y"":156,""width"":793,""height"":732}",{},732,rect,793,134,156,/home/dianwen/SIIM_ACR/train/images/1024/dicom/1.2.276.0.7230010.3.1.4.8323329.431.1517875162.902494.png,/home/dianwen/SIIM_ACR/train/images/1024/mask/1.2.276.0.7230010.3.1.4.8323329.431.1517875162.902494.png,0.0,0.0,888,927
1.2.276.0.7230010.3.1.4.8323329.432.1517875162.913455.png,329322,{},1,0,"{""name"":""rect"",""x"":71,""y"":86,""width"":870,""height"":650}",{},650,rect,870,71,86,/home/dianwen/SIIM_ACR/train/images/1024/dicom/1.2.276.0.7230010.3.1.4.8323329.432.1517875162.913455.png,/home/dianwen/SIIM_ACR/train/images/1024/mask/1.2.276.0.7230010.3.1.4.8323329.432.1517875162.913455.png,0.0,0.0,736,941
1.2.276.0.7230010.3.1.4.8323329.433.1517875162.910846.png,432063,{},1,0,"{""name"":""rect"",""x"":8,""y"":103,""width"":957,""height"":729}",{},729,rect,957,8,103,/home/dianwen/SIIM_ACR/train/images/1024/dicom/1.2.276.0.7230010.3.1.4.8323329.433.1517875162.910846.png,/home/dianwen/SIIM_ACR/train/images/1024/mask/1.2.276.0.7230010.3.1.4.8323329.433.1517875162.910846.png,0.0,0.0,832,965
1.2.276.0.7230010.3.1.4.8323329.434.1517875162.915932.png,427587,{},1,0,"{""name"":""rect"",""x"":120,""y"":96,""width"":848,""height"":887}",{},887,rect,848,120,96,/home/dianwen/SIIM_ACR/train/images/1024/dicom/1.2.276.0.7230010.3.1.4.8323329.434.1517875162.915932.png,/home/dianwen/SIIM_ACR/train/images/1024/mask/1.2.276.0.7230010.3.1.4.8323329.434.1517875162.915932.png,0.0,0.0,983,968
1.2.276.0.7230010.3.1.4.8323329.435.1517875162.931776.png,395072,{},1,0,"{""name"":""rect"",""x"":88,""y"":133,""width"":714,""height"":795}",{},795,rect,714,88,133,/home/dianwen/SIIM_ACR/train/images/1024/dicom/1.2.276.0.7230010.3.1.4.8323329.435.1517875162.931776.png,/home/dianwen/SIIM_ACR/train/images/1024/mask/1.2.276.0.7230010.3.1.4.8323329.435.1517875162.931776.png,0.0,0.0,928,802
1.2.276.0.7230010.3.1.4.8323329.436.1517875162.928477.png,370883,{},1,0,"{""name"":""rect"",""x"":241,""y"":159,""width"":725,""height"":759}",{},759,rect,725,241,159,/home/dianwen/SIIM_ACR/train/images/1024/dicom/1.2.276.0.7230010.3.1.4.8323329.436.1517875162.928477.png,/home/dianwen/SIIM_ACR/train/images/1024/mask/1.2.276.0.7230010.3.1.4.8323329.436.1517875162.928477.png,0.0,0.0,918,966
1.2.276.0.7230010.3.1.4.8323329.437.1517875162.943042.png,390592,{},1,0,"{""name"":""rect"",""x"":125,""y"":6,""width"":821,""height"":1012}",{},1012,rect,821,125,6,/home/dianwen/SIIM_ACR/train/images/1024/dicom/1.2.276.0.7230010.3.1.4.8323329.437.1517875162.943042.png,/home/dianwen/SIIM_ACR/train/images/1024/mask/1.2.276.0.7230010.3.1.4.8323329.437.1517875162.943042.png,0.0,0.0,1018,946
1.2.276.0.7230010.3.1.4.8323329.438.1517875162.937614.png,338290,{},1,0,"{""name"":""rect"",""x"":87,""y"":126,""width"":714,""height"":628}",{},628,rect,714,87,126,/home/dianwen/SIIM_ACR/train/images/1024/dicom/1.2.276.0.7230010.3.1.4.8323329.438.1517875162.937614.png,/home/dianwen/SIIM_ACR/train/images/1024/mask/1.2.276.0.7230010.3.1.4.8323329.438.1517875162.937614.png,0.0,0.0,754,801
1.2.276.0.7230010.3.1.4.8323329.439.1517875162.950268.png,434616,{},1,0,"{""name"":""rect"",""x"":134,""y"":57,""width"":758,""height"":743}",{},743,rect,758,134,57,/home/dianwen/SIIM_ACR/train/images/1024/dicom/1.2.276.0.7230010.3.1.4.8323329.439.1517875162.950268.png,/home/dianwen/SIIM_ACR/train/images/1024/mask/1.2.276.0.7230010.3.1.4.8323329.439.1517875162.950268.png,0.010137557983398438,1.0,800,892
1.2.276.0.7230010.3.1.4.8323329.440.1517875162.950678.png,425690,{},1,0,"{""name"":""rect"",""x"":149,""y"":116,""width"":707,""height"":733}",{},733,rect,707,149,116,/home/dianwen/SIIM_ACR/train/images/1024/dicom/1.2.276.0.7230010.3.1.4.8323329.440.1517875162.950678.png,/home/dianwen/SIIM_ACR/train/images/1024/mask/1.2.276.0.7230010.3.1.4.8323329.440.1517875162.950678.png,0.002758026123046875,1.0,849,856
1.2.276.0.7230010.3.1.4.8323329.441.1517875162.951483.png,377676,{},1,0,"{""name"":""rect"",""x"":95,""y"":121,""width"":835,""height"":674}",{},674,rect,835,95,121,/home/dianwen/SIIM_ACR/train/images/1024/dicom/1.2.276.0.7230010.3.1.4.8323329.441.1517875162.951483.png,/home/dianwen/SIIM_ACR/train/images/1024/mask/1.2.276.0.7230010.3.1.4.8323329.441.1517875162.951483.png,0.0016803741455078125,1.0,795,930
1.2.276.0.7230010.3.1.4.8323329.442.1517875162.952364.png,462869,{},1,0,"{""name"":""rect"",""x"":32,""y"":110,""width"":969,""height"":824}",{},824,rect,969,32,110,/home/dianwen/SIIM_ACR/train/images/1024/dicom/1.2.276.0.7230010.3.1.4.8323329.442.1517875162.952364.png,/home/dianwen/SIIM_ACR/train/images/1024/mask/1.2.276.0.7230010.3.1.4.8323329.442.1517875162.952364.png,0.0,0.0,934,1001
1.2.276.0.7230010.3.1.4.8323329.443.1517875162.958227.png,298822,{},1,0,"{""name"":""rect"",""x"":47,""y"":235,""width"":908,""height"":749}",{},749,rect,908,47,235,/home/dianwen/SIIM_ACR/train/images/1024/dicom/1.2.276.0.7230010.3.1.4.8323329.443.1517875162.958227.png,/home/dianwen/SIIM_ACR/train/images/1024/mask/1.2.276.0.7230010.3.1.4.8323329.443.1517875162.958227.png,0.0,0.0,984,955
1.2.276.0.7230010.3.1.4.8323329.444.1517875162.970305.png,353742,{},1,0,"{""name"":""rect"",""x"":129,""y"":37,""width"":745,""height"":810}",{},810,rect,745,129,37,/home/dianwen/SIIM_ACR/train/images/1024/dicom/1.2.276.0.7230010.3.1.4.8323329.444.1517875162.970305.png,/home/dianwen/SIIM_ACR/train/images/1024/mask/1.2.276.0.7230010.3.1.4.8323329.444.1517875162.970305.png,0.004897117614746094,1.0,847,874
1.2.276.0.7230010.3.1.4.8323329.445.1517875162.972269.png,443955,{},1,0,"{""name"":""rect"",""x"":48,""y"":59,""width"":935,""height"":767}",{},767,rect,935,48,59,/home/dianwen/SIIM_ACR/train/images/1024/dicom/1.2.276.0.7230010.3.1.4.8323329.445.1517875162.972269.png,/home/dianwen/SIIM_ACR/train/images/1024/mask/1.2.276.0.7230010.3.1.4.8323329.445.1517875162.972269.png,0.0,0.0,826,983
1.2.276.0.7230010.3.1.4.8323329.446.1517875162.978336.png,425987,{},1,0,"{""name"":""rect"",""x"":78,""y"":50,""width"":838,""height"":802}",{},802,rect,838,78,50,/home/dianwen/SIIM_ACR/train/images/1024/dicom/1.2.276.0.7230010.3.1.4.8323329.446.1517875162.978336.png,/home/dianwen/SIIM_ACR/train/images/1024/mask/1.2.276.0.7230010.3.1.4.8323329.446.1517875162.978336.png,0.0,0.0,852,916
1.2.276.0.7230010.3.1.4.8323329.447.1517875162.983007.png,396516,{},1,0,"{""name"":""rect"",""x"":101,""y"":169,""width"":794,""height"":843}",{},843,rect,794,101,169,/home/dianwen/SIIM_ACR/train/images/1024/dicom/1.2.276.0.7230010.3.1.4.8323329.447.1517875162.983007.png,/home/dianwen/SIIM_ACR/train/images/1024/mask/1.2.276.0.7230010.3.1.4.8323329.447.1517875162.983007.png,0.0,0.0,1012,895
1.2.276.0.7230010.3.1.4.8323329.448.1517875162.988074.png,389017,{},1,0,"{""name"":""rect"",""x"":170,""y"":166,""width"":732,""height"":681}",{},681,rect,732,170,166,/home/dianwen/SIIM_ACR/train/images/1024/dicom/1.2.276.0.7230010.3.1.4.8323329.448.1517875162.988074.png,/home/dianwen/SIIM_ACR/train/images/1024/mask/1.2.276.0.7230010.3.1.4.8323329.448.1517875162.988074.png,0.036273956298828125,1.0,847,902
1.2.276.0.7230010.3.1.4.8323329.449.1517875162.992874.png,357055,{},1,0,"{""name"":""rect"",""x"":134,""y"":101,""width"":764,""height"":878}",{},878,rect,764,134,101,/home/dianwen/SIIM_ACR/train/images/1024/dicom/1.2.276.0.7230010.3.1.4.8323329.449.1517875162.992874.png,/home/dianwen/SIIM_ACR/train/images/1024/mask/1.2.276.0.7230010.3.1.4.8323329.449.1517875162.992874.png,0.0,0.0,979,898
1.2.276.0.7230010.3.1.4.8323329.450.1517875162.993658.png,412279,{},1,0,"{""name"":""rect"",""x"":41,""y"":84,""width"":895,""height"":745}",{},745,rect,895,41,84,/home/dianwen/SIIM_ACR/train/images/1024/dicom/1.2.276.0.7230010.3.1.4.8323329.450.1517875162.993658.png,/home/dianwen/SIIM_ACR/train/images/1024/mask/1.2.276.0.7230010.3.1.4.8323329.450.1517875162.993658.png,0.0,0.0,829,936
1.2.276.0.7230010.3.1.4.8323329.451.1517875162.996515.png,425948,{},1,0,"{""name"":""rect"",""x"":139,""y"":117,""width"":793,""height"":739}",{},739,rect,793,139,117,/home/dianwen/SIIM_ACR/train/images/1024/dicom/1.2.276.0.7230010.3.1.4.8323329.451.1517875162.996515.png,/home/dianwen/SIIM_ACR/train/images/1024/mask/1.2.276.0.7230010.3.1.4.8323329.451.1517875162.996515.png,0.0,0.0,856,932
1.2.276.0.7230010.3.1.4.8323329.452.1517875162.2142.png,424673,{},1,0,"{""name"":""rect"",""x"":144,""y"":57,""width"":765,""height"":623}",{},623,rect,765,144,57,/home/dianwen/SIIM_ACR/train/images/1024/dicom/1.2.276.0.7230010.3.1.4.8323329.452.1517875162.2142.png,/home/dianwen/SIIM_ACR/train/images/1024/mask/1.2.276.0.7230010.3.1.4.8323329.452.1517875162.2142.png,0.0,0.0,680,909
1.2.276.0.7230010.3.1.4.8323329.453.1517875163.10656.png,335251,{},1,0,"{""name"":""rect"",""x"":59,""y"":116,""width"":738,""height"":678}",{},678,rect,738,59,116,/home/dianwen/SIIM_ACR/train/images/1024/dicom/1.2.276.0.7230010.3.1.4.8323329.453.1517875163.10656.png,/home/dianwen/SIIM_ACR/train/images/1024/mask/1.2.276.0.7230010.3.1.4.8323329.453.1517875163.10656.png,0.0,0.0,794,797
1.2.276.0.7230010.3.1.4.8323329.454.1517875163.8726.png,427791,{},1,0,"{""name"":""rect"",""x"":90,""y"":4,""width"":777,""height"":749}",{},749,rect,777,90,4,/home/dianwen/SIIM_ACR/train/images/1024/dicom/1.2.276.0.7230010.3.1.4.8323329.454.1517875163.8726.png,/home/dianwen/SIIM_ACR/train/images/1024/mask/1.2.276.0.7230010.3.1.4.8323329.454.1517875163.8726.png,0.0,0.0,753,867
1.2.276.0.7230010.3.1.4.8323329.455.1517875163.12962.png,356918,{},1,0,"{""name"":""rect"",""x"":154,""y"":119,""width"":788,""height"":767}",{},767,rect,788,154,119,/home/dianwen/SIIM_ACR/train/images/1024/dicom/1.2.276.0.7230010.3.1.4.8323329.455.1517875163.12962.png,/home/dianwen/SIIM_ACR/train/images/1024/mask/1.2.276.0.7230010.3.1.4.8323329.455.1517875163.12962.png,0.0,0.0,886,942
1.2.276.0.7230010.3.1.4.8323329.456.1517875163.29798.png,392964,{},1,0,"{""name"":""rect"",""x"":153,""y"":113,""width"":708,""height"":712}",{},712,rect,708,153,113,/home/dianwen/SIIM_ACR/train/images/1024/dicom/1.2.276.0.7230010.3.1.4.8323329.456.1517875163.29798.png,/home/dianwen/SIIM_ACR/train/images/1024/mask/1.2.276.0.7230010.3.1.4.8323329.456.1517875163.29798.png,0.0,0.0,825,861
1.2.276.0.7230010.3.1.4.8323329.457.1517875163.32226.png,319703,{},1,0,"{""name"":""rect"",""x"":172,""y"":139,""width"":840,""height"":871}",{},871,rect,840,172,139,/home/dianwen/SIIM_ACR/train/images/1024/dicom/1.2.276.0.7230010.3.1.4.8323329.457.1517875163.32226.png,/home/dianwen/SIIM_ACR/train/images/1024/mask/1.2.276.0.7230010.3.1.4.8323329.457.1517875163.32226.png,0.0,0.0,1010,1012
1.2.276.0.7230010.3.1.4.8323329.458.1517875163.31862.png,441536,{},1,0,"{""name"":""rect"",""x"":23,""y"":102,""width"":928,""height"":675}",{},675,rect,928,23,102,/home/dianwen/SIIM_ACR/train/images/1024/dicom/1.2.276.0.7230010.3.1.4.8323329.458.1517875163.31862.png,/home/dianwen/SIIM_ACR/train/images/1024/mask/1.2.276.0.7230010.3.1.4.8323329.458.1517875163.31862.png,0.0,0.0,777,951
1.2.276.0.7230010.3.1.4.8323329.459.1517875163.32759.png,385800,{},1,0,"{""name"":""rect"",""x"":167,""y"":174,""width"":692,""height"":590}",{},590,rect,692,167,174,/home/dianwen/SIIM_ACR/train/images/1024/dicom/1.2.276.0.7230010.3.1.4.8323329.459.1517875163.32759.png,/home/dianwen/SIIM_ACR/train/images/1024/mask/1.2.276.0.7230010.3.1.4.8323329.459.1517875163.32759.png,0.0,0.0,764,859
1.2.276.0.7230010.3.1.4.8323329.460.1517875163.52377.png,364197,{},1,0,"{""name"":""rect"",""x"":41,""y"":35,""width"":887,""height"":899}",{},899,rect,887,41,35,/home/dianwen/SIIM_ACR/train/images/1024/dicom/1.2.276.0.7230010.3.1.4.8323329.460.1517875163.52377.png,/home/dianwen/SIIM_ACR/train/images/1024/mask/1.2.276.0.7230010.3.1.4.8323329.460.1517875163.52377.png,0.0,0.0,934,928
1.2.276.0.7230010.3.1.4.8323329.461.1517875163.62510.png,304012,{},1,0,"{""name"":""rect"",""x"":167,""y"":2,""width"":857,""height"":673}",{},673,rect,857,167,2,/home/dianwen/SIIM_ACR/train/images/1024/dicom/1.2.276.0.7230010.3.1.4.8323329.461.1517875163.62510.png,/home/dianwen/SIIM_ACR/train/images/1024/mask/1.2.276.0.7230010.3.1.4.8323329.461.1517875163.62510.png,0.0,0.0,675,1024
1.2.276.0.7230010.3.1.4.8323329.462.1517875163.54988.png,342904,{},1,0,"{""name"":""rect"",""x"":163,""y"":78,""width"":774,""height"":776}",{},776,rect,774,163,78,/home/dianwen/SIIM_ACR/train/images/1024/dicom/1.2.276.0.7230010.3.1.4.8323329.462.1517875163.54988.png,/home/dianwen/SIIM_ACR/train/images/1024/mask/1.2.276.0.7230010.3.1.4.8323329.462.1517875163.54988.png,0.0,0.0,854,937
1.2.276.0.7230010.3.1.4.8323329.463.1517875163.62182.png,392567,{},1,0,"{""name"":""rect"",""x"":99,""y"":262,""width"":780,""height"":684}",{},684,rect,780,99,262,/home/dianwen/SIIM_ACR/train/images/1024/dicom/1.2.276.0.7230010.3.1.4.8323329.463.1517875163.62182.png,/home/dianwen/SIIM_ACR/train/images/1024/mask/1.2.276.0.7230010.3.1.4.8323329.463.1517875163.62182.png,0.0,0.0,946,879
1.2.276.0.7230010.3.1.4.8323329.464.1517875163.75117.png,399290,{},1,0,"{""name"":""rect"",""x"":104,""y"":76,""width"":712,""height"":647}",{},647,rect,712,104,76,/home/dianwen/SIIM_ACR/train/images/1024/dicom/1.2.276.0.7230010.3.1.4.8323329.464.1517875163.75117.png,/home/dianwen/SIIM_ACR/train/images/1024/mask/1.2.276.0.7230010.3.1.4.8323329.464.1517875163.75117.png,0.0,0.0,723,816
1.2.276.0.7230010.3.1.4.8323329.465.1517875163.76033.png,329190,{},1,0,"{""name"":""rect"",""x"":228,""y"":83,""width"":656,""height"":715}",{},715,rect,656,228,83,/home/dianwen/SIIM_ACR/train/images/1024/dicom/1.2.276.0.7230010.3.1.4.8323329.465.1517875163.76033.png,/home/dianwen/SIIM_ACR/train/images/1024/mask/1.2.276.0.7230010.3.1.4.8323329.465.1517875163.76033.png,0.0,0.0,798,884
1.2.276.0.7230010.3.1.4.8323329.466.1517875163.78483.png,289728,{},1,0,"{""name"":""rect"",""x"":342,""y"":44,""width"":673,""height"":835}",{},835,rect,673,342,44,/home/dianwen/SIIM_ACR/train/images/1024/dicom/1.2.276.0.7230010.3.1.4.8323329.466.1517875163.78483.png,/home/dianwen/SIIM_ACR/train/images/1024/mask/1.2.276.0.7230010.3.1.4.8323329.466.1517875163.78483.png,0.0,0.0,879,1015
1.2.276.0.7230010.3.1.4.8323329.467.1517875163.89303.png,403742,{},1,0,"{""name"":""rect"",""x"":106,""y"":54,""width"":692,""height"":774}",{},774,rect,692,106,54,/home/dianwen/SIIM_ACR/train/images/1024/dicom/1.2.276.0.7230010.3.1.4.8323329.467.1517875163.89303.png,/home/dianwen/SIIM_ACR/train/images/1024/mask/1.2.276.0.7230010.3.1.4.8323329.467.1517875163.89303.png,0.0,0.0,828,798
1.2.276.0.7230010.3.1.4.8323329.468.1517875163.86464.png,409952,{},1,0,"{""name"":""rect"",""x"":58,""y"":117,""width"":848,""height"":801}",{},801,rect,848,58,117,/home/dianwen/SIIM_ACR/train/images/1024/dicom/1.2.276.0.7230010.3.1.4.8323329.468.1517875163.86464.png,/home/dianwen/SIIM_ACR/train/images/1024/mask/1.2.276.0.7230010.3.1.4.8323329.468.1517875163.86464.png,0.001827239990234375,1.0,918,906
1.2.276.0.7230010.3.1.4.8323329.469.1517875163.112138.png,398204,{},1,0,"{""name"":""rect"",""x"":119,""y"":118,""width"":808,""height"":706}",{},706,rect,808,119,118,/home/dianwen/SIIM_ACR/train/images/1024/dicom/1.2.276.0.7230010.3.1.4.8323329.469.1517875163.112138.png,/home/dianwen/SIIM_ACR/train/images/1024/mask/1.2.276.0.7230010.3.1.4.8323329.469.1517875163.112138.png,0.0,0.0,824,927
1.2.276.0.7230010.3.1.4.8323329.470.1517875163.106921.png,434411,{},1,0,"{""name"":""rect"",""x"":151,""y"":3,""width"":814,""height"":887}",{},887,rect,814,151,3,/home/dianwen/SIIM_ACR/train/images/1024/dicom/1.2.276.0.7230010.3.1.4.8323329.470.1517875163.106921.png,/home/dianwen/SIIM_ACR/train/images/1024/mask/1.2.276.0.7230010.3.1.4.8323329.470.1517875163.106921.png,0.005974769592285156,1.0,890,965
1.2.276.0.7230010.3.1.4.8323329.471.1517875163.111646.png,437150,{},1,0,"{""name"":""rect"",""x"":89,""y"":66,""width"":891,""height"":913}",{},913,rect,891,89,66,/home/dianwen/SIIM_ACR/train/images/1024/dicom/1.2.276.0.7230010.3.1.4.8323329.471.1517875163.111646.png,/home/dianwen/SIIM_ACR/train/images/1024/mask/1.2.276.0.7230010.3.1.4.8323329.471.1517875163.111646.png,0.002475738525390625,1.0,979,980
1.2.276.0.7230010.3.1.4.8323329.472.1517875163.106052.png,394952,{},1,0,"{""name"":""rect"",""x"":135,""y"":96,""width"":750,""height"":810}",{},810,rect,750,135,96,/home/dianwen/SIIM_ACR/train/images/1024/dicom/1.2.276.0.7230010.3.1.4.8323329.472.1517875163.106052.png,/home/dianwen/SIIM_ACR/train/images/1024/mask/1.2.276.0.7230010.3.1.4.8323329.472.1517875163.106052.png,0.0,0.0,906,885
1.2.276.0.7230010.3.1.4.8323329.473.1517875163.101438.png,373438,{},1,0,"{""name"":""rect"",""x"":107,""y"":59,""width"":897,""height"":801}",{},801,rect,897,107,59,/home/dianwen/SIIM_ACR/train/images/1024/dicom/1.2.276.0.7230010.3.1.4.8323329.473.1517875163.101438.png,/home/dianwen/SIIM_ACR/train/images/1024/mask/1.2.276.0.7230010.3.1.4.8323329.473.1517875163.101438.png,0.0,0.0,860,1004
1.2.276.0.7230010.3.1.4.8323329.474.1517875163.118966.png,347348,{},1,0,"{""name"":""rect"",""x"":147,""y"":100,""width"":777,""height"":826}",{},826,rect,777,147,100,/home/dianwen/SIIM_ACR/train/images/1024/dicom/1.2.276.0.7230010.3.1.4.8323329.474.1517875163.118966.png,/home/dianwen/SIIM_ACR/train/images/1024/mask/1.2.276.0.7230010.3.1.4.8323329.474.1517875163.118966.png,0.01155376434326172,1.0,926,924
1.2.276.0.7230010.3.1.4.8323329.475.1517875163.123986.png,375580,{},1,0,"{""name"":""rect"",""x"":183,""y"":59,""width"":668,""height"":846}",{},846,rect,668,183,59,/home/dianwen/SIIM_ACR/train/images/1024/dicom/1.2.276.0.7230010.3.1.4.8323329.475.1517875163.123986.png,/home/dianwen/SIIM_ACR/train/images/1024/mask/1.2.276.0.7230010.3.1.4.8323329.475.1517875163.123986.png,0.007880210876464844,1.0,905,851
1.2.276.0.7230010.3.1.4.8323329.476.1517875163.123986.png,368814,{},1,0,"{""name"":""rect"",""x"":111,""y"":66,""width"":745,""height"":671}",{},671,rect,745,111,66,/home/dianwen/SIIM_ACR/train/images/1024/dicom/1.2.276.0.7230010.3.1.4.8323329.476.1517875163.123986.png,/home/dianwen/SIIM_ACR/train/images/1024/mask/1.2.276.0.7230010.3.1.4.8323329.476.1517875163.123986.png,0.0,0.0,737,856
1.2.276.0.7230010.3.1.4.8323329.477.1517875163.135825.png,435242,{},1,0,"{""name"":""rect"",""x"":134,""y"":2,""width"":768,""height"":745}",{},745,rect,768,134,2,/home/dianwen/SIIM_ACR/train/images/1024/dicom/1.2.276.0.7230010.3.1.4.8323329.477.1517875163.135825.png,/home/dianwen/SIIM_ACR/train/images/1024/mask/1.2.276.0.7230010.3.1.4.8323329.477.1517875163.135825.png,0.0,0.0,747,902
1.2.276.0.7230010.3.1.4.8323329.478.1517875163.136295.png,345293,{},1,0,"{""name"":""rect"",""x"":66,""y"":72,""width"":812,""height"":881}",{},881,rect,812,66,72,/home/dianwen/SIIM_ACR/train/images/1024/dicom/1.2.276.0.7230010.3.1.4.8323329.478.1517875163.136295.png,/home/dianwen/SIIM_ACR/train/images/1024/mask/1.2.276.0.7230010.3.1.4.8323329.478.1517875163.136295.png,0.0,0.0,953,878
1.2.276.0.7230010.3.1.4.8323329.479.1517875163.132546.png,396205,{},1,0,"{""name"":""rect"",""x"":176,""y"":100,""width"":737,""height"":744}",{},744,rect,737,176,100,/home/dianwen/SIIM_ACR/train/images/1024/dicom/1.2.276.0.7230010.3.1.4.8323329.479.1517875163.132546.png,/home/dianwen/SIIM_ACR/train/images/1024/mask/1.2.276.0.7230010.3.1.4.8323329.479.1517875163.132546.png,0.0092010498046875,1.0,844,913
1.2.276.0.7230010.3.1.4.8323329.480.1517875163.138840.png,387195,{},1,0,"{""name"":""rect"",""x"":153,""y"":101,""width"":871,""height"":819}",{},819,rect,871,153,101,/home/dianwen/SIIM_ACR/train/images/1024/dicom/1.2.276.0.7230010.3.1.4.8323329.480.1517875163.138840.png,/home/dianwen/SIIM_ACR/train/images/1024/mask/1.2.276.0.7230010.3.1.4.8323329.480.1517875163.138840.png,0.0,0.0,920,1024
1.2.276.0.7230010.3.1.4.8323329.481.1517875163.149606.png,409012,{},1,0,"{""name"":""rect"",""x"":123,""y"":83,""width"":745,""height"":700}",{},700,rect,745,123,83,/home/dianwen/SIIM_ACR/train/images/1024/dicom/1.2.276.0.7230010.3.1.4.8323329.481.1517875163.149606.png,/home/dianwen/SIIM_ACR/train/images/1024/mask/1.2.276.0.7230010.3.1.4.8323329.481.1517875163.149606.png,0.001857757568359375,1.0,783,868
1.2.276.0.7230010.3.1.4.8323329.482.1517875163.139408.png,383386,{},1,0,"{""name"":""rect"",""x"":70,""y"":142,""width"":865,""height"":732}",{},732,rect,865,70,142,/home/dianwen/SIIM_ACR/train/images/1024/dicom/1.2.276.0.7230010.3.1.4.8323329.482.1517875163.139408.png,/home/dianwen/SIIM_ACR/train/images/1024/mask/1.2.276.0.7230010.3.1.4.8323329.482.1517875163.139408.png,0.0,0.0,874,935
1.2.276.0.7230010.3.1.4.8323329.483.1517875163.155408.png,437971,{},1,0,"{""name"":""rect"",""x"":48,""y"":130,""width"":931,""height"":697}",{},697,rect,931,48,130,/home/dianwen/SIIM_ACR/train/images/1024/dicom/1.2.276.0.7230010.3.1.4.8323329.483.1517875163.155408.png,/home/dianwen/SIIM_ACR/train/images/1024/mask/1.2.276.0.7230010.3.1.4.8323329.483.1517875163.155408.png,0.0,0.0,827,979
1.2.276.0.7230010.3.1.4.8323329.484.1517875163.154177.png,315466,{},1,0,"{""name"":""rect"",""x"":170,""y"":159,""width"":740,""height"":828}",{},828,rect,740,170,159,/home/dianwen/SIIM_ACR/train/images/1024/dicom/1.2.276.0.7230010.3.1.4.8323329.484.1517875163.154177.png,/home/dianwen/SIIM_ACR/train/images/1024/mask/1.2.276.0.7230010.3.1.4.8323329.484.1517875163.154177.png,0.03316497802734375,1.0,987,910
1.2.276.0.7230010.3.1.4.8323329.485.1517875163.163571.png,378826,{},1,0,"{""name"":""rect"",""x"":80,""y"":59,""width"":891,""height"":717}",{},717,rect,891,80,59,/home/dianwen/SIIM_ACR/train/images/1024/dicom/1.2.276.0.7230010.3.1.4.8323329.485.1517875163.163571.png,/home/dianwen/SIIM_ACR/train/images/1024/mask/1.2.276.0.7230010.3.1.4.8323329.485.1517875163.163571.png,0.0,0.0,776,971
1.2.276.0.7230010.3.1.4.8323329.486.1517875163.156313.png,319104,{},1,0,"{""name"":""rect"",""x"":91,""y"":32,""width"":706,""height"":824}",{},824,rect,706,91,32,/home/dianwen/SIIM_ACR/train/images/1024/dicom/1.2.276.0.7230010.3.1.4.8323329.486.1517875163.156313.png,/home/dianwen/SIIM_ACR/train/images/1024/mask/1.2.276.0.7230010.3.1.4.8323329.486.1517875163.156313.png,0.04373455047607422,1.0,856,797
1.2.276.0.7230010.3.1.4.8323329.487.1517875163.168343.png,392407,{},1,0,"{""name"":""rect"",""x"":83,""y"":177,""width"":812,""height"":845}",{},845,rect,812,83,177,/home/dianwen/SIIM_ACR/train/images/1024/dicom/1.2.276.0.7230010.3.1.4.8323329.487.1517875163.168343.png,/home/dianwen/SIIM_ACR/train/images/1024/mask/1.2.276.0.7230010.3.1.4.8323329.487.1517875163.168343.png,0.0,0.0,1022,895
1.2.276.0.7230010.3.1.4.8323329.488.1517875163.169307.png,335082,{},1,0,"{""name"":""rect"",""x"":29,""y"":91,""width"":821,""height"":914}",{},914,rect,821,29,91,/home/dianwen/SIIM_ACR/train/images/1024/dicom/1.2.276.0.7230010.3.1.4.8323329.488.1517875163.169307.png,/home/dianwen/SIIM_ACR/train/images/1024/mask/1.2.276.0.7230010.3.1.4.8323329.488.1517875163.169307.png,0.0,0.0,1005,850
1.2.276.0.7230010.3.1.4.8323329.489.1517875163.169250.png,335036,{},1,0,"{""name"":""rect"",""x"":156,""y"":127,""width"":796,""height"":893}",{},893,rect,796,156,127,/home/dianwen/SIIM_ACR/train/images/1024/dicom/1.2.276.0.7230010.3.1.4.8323329.489.1517875163.169250.png,/home/dianwen/SIIM_ACR/train/images/1024/mask/1.2.276.0.7230010.3.1.4.8323329.489.1517875163.169250.png,0.0,0.0,1020,952
1.2.276.0.7230010.3.1.4.8323329.490.1517875163.168771.png,350154,{},1,0,"{""name"":""rect"",""x"":76,""y"":83,""width"":899,""height"":790}",{},790,rect,899,76,83,/home/dianwen/SIIM_ACR/train/images/1024/dicom/1.2.276.0.7230010.3.1.4.8323329.490.1517875163.168771.png,/home/dianwen/SIIM_ACR/train/images/1024/mask/1.2.276.0.7230010.3.1.4.8323329.490.1517875163.168771.png,0.0,0.0,873,975
1.2.276.0.7230010.3.1.4.8323329.491.1517875163.187701.png,336837,{},1,0,"{""name"":""rect"",""x"":142,""y"":175,""width"":770,""height"":694}",{},694,rect,770,142,175,/home/dianwen/SIIM_ACR/train/images/1024/dicom/1.2.276.0.7230010.3.1.4.8323329.491.1517875163.187701.png,/home/dianwen/SIIM_ACR/train/images/1024/mask/1.2.276.0.7230010.3.1.4.8323329.491.1517875163.187701.png,0.0,0.0,869,912
1.2.276.0.7230010.3.1.4.8323329.492.1517875163.185084.png,378848,{},1,0,"{""name"":""rect"",""x"":140,""y"":203,""width"":848,""height"":797}",{},797,rect,848,140,203,/home/dianwen/SIIM_ACR/train/images/1024/dicom/1.2.276.0.7230010.3.1.4.8323329.492.1517875163.185084.png,/home/dianwen/SIIM_ACR/train/images/1024/mask/1.2.276.0.7230010.3.1.4.8323329.492.1517875163.185084.png,0.0,0.0,1000,988
1.2.276.0.7230010.3.1.4.8323329.493.1517875163.179733.png,318841,{},1,0,"{""name"":""rect"",""x"":151,""y"":138,""width"":749,""height"":709}",{},709,rect,749,151,138,/home/dianwen/SIIM_ACR/train/images/1024/dicom/1.2.276.0.7230010.3.1.4.8323329.493.1517875163.179733.png,/home/dianwen/SIIM_ACR/train/images/1024/mask/1.2.276.0.7230010.3.1.4.8323329.493.1517875163.179733.png,0.0,0.0,847,900
1.2.276.0.7230010.3.1.4.8323329.495.1517875163.183419.png,371693,{},1,0,"{""name"":""rect"",""x"":153,""y"":43,""width"":749,""height"":724}",{},724,rect,749,153,43,/home/dianwen/SIIM_ACR/train/images/1024/dicom/1.2.276.0.7230010.3.1.4.8323329.495.1517875163.183419.png,/home/dianwen/SIIM_ACR/train/images/1024/mask/1.2.276.0.7230010.3.1.4.8323329.495.1517875163.183419.png,0.0,0.0,767,902
1.2.276.0.7230010.3.1.4.8323329.496.1517875163.190846.png,411239,{},1,0,"{""name"":""rect"",""x"":50,""y"":84,""width"":879,""height"":736}",{},736,rect,879,50,84,/home/dianwen/SIIM_ACR/train/images/1024/dicom/1.2.276.0.7230010.3.1.4.8323329.496.1517875163.190846.png,/home/dianwen/SIIM_ACR/train/images/1024/mask/1.2.276.0.7230010.3.1.4.8323329.496.1517875163.190846.png,0.0,0.0,820,929
1.2.276.0.7230010.3.1.4.8323329.497.1517875163.185132.png,415348,{},1,0,"{""name"":""rect"",""x"":107,""y"":77,""width"":826,""height"":825}",{},825,rect,826,107,77,/home/dianwen/SIIM_ACR/train/images/1024/dicom/1.2.276.0.7230010.3.1.4.8323329.497.1517875163.185132.png,/home/dianwen/SIIM_ACR/train/images/1024/mask/1.2.276.0.7230010.3.1.4.8323329.497.1517875163.185132.png,0.013698577880859377,1.0,902,933
1.2.276.0.7230010.3.1.4.8323329.498.1517875163.202529.png,427977,{},1,0,"{""name"":""rect"",""x"":114,""y"":51,""width"":850,""height"":769}",{},769,rect,850,114,51,/home/dianwen/SIIM_ACR/train/images/1024/dicom/1.2.276.0.7230010.3.1.4.8323329.498.1517875163.202529.png,/home/dianwen/SIIM_ACR/train/images/1024/mask/1.2.276.0.7230010.3.1.4.8323329.498.1517875163.202529.png,0.0,0.0,820,964
1.2.276.0.7230010.3.1.4.8323329.499.1517875163.196230.png,424619,{},1,0,"{""name"":""rect"",""x"":52,""y"":152,""width"":891,""height"":735}",{},735,rect,891,52,152,/home/dianwen/SIIM_ACR/train/images/1024/dicom/1.2.276.0.7230010.3.1.4.8323329.499.1517875163.196230.png,/home/dianwen/SIIM_ACR/train/images/1024/mask/1.2.276.0.7230010.3.1.4.8323329.499.1517875163.196230.png,0.0,0.0,887,943
1.2.276.0.7230010.3.1.4.8323329.500.1517875163.209276.png,397367,{},1,0,"{""name"":""rect"",""x"":137,""y"":61,""width"":677,""height"":869}",{},869,rect,677,137,61,/home/dianwen/SIIM_ACR/train/images/1024/dicom/1.2.276.0.7230010.3.1.4.8323329.500.1517875163.209276.png,/home/dianwen/SIIM_ACR/train/images/1024/mask/1.2.276.0.7230010.3.1.4.8323329.500.1517875163.209276.png,0.005321502685546875,1.0,930,814
1.2.276.0.7230010.3.1.4.8323329.501.1517875163.206998.png,364430,{},1,0,"{""name"":""rect"",""x"":25,""y"":54,""width"":906,""height"":758}",{},758,rect,906,25,54,/home/dianwen/SIIM_ACR/train/images/1024/dicom/1.2.276.0.7230010.3.1.4.8323329.501.1517875163.206998.png,/home/dianwen/SIIM_ACR/train/images/1024/mask/1.2.276.0.7230010.3.1.4.8323329.501.1517875163.206998.png,0.0,0.0,812,931
1.2.276.0.7230010.3.1.4.8323329.502.1517875163.208009.png,438995,{},1,0,"{""name"":""rect"",""x"":54,""y"":111,""width"":938,""height"":896}",{},896,rect,938,54,111,/home/dianwen/SIIM_ACR/train/images/1024/dicom/1.2.276.0.7230010.3.1.4.8323329.502.1517875163.208009.png,/home/dianwen/SIIM_ACR/train/images/1024/mask/1.2.276.0.7230010.3.1.4.8323329.502.1517875163.208009.png,0.0,0.0,1007,992
1.2.276.0.7230010.3.1.4.8323329.503.1517875163.216019.png,442500,{},1,0,"{""name"":""rect"",""x"":25,""y"":53,""width"":868,""height"":746}",{},746,rect,868,25,53,/home/dianwen/SIIM_ACR/train/images/1024/dicom/1.2.276.0.7230010.3.1.4.8323329.503.1517875163.216019.png,/home/dianwen/SIIM_ACR/train/images/1024/mask/1.2.276.0.7230010.3.1.4.8323329.503.1517875163.216019.png,0.00232696533203125,1.0,799,893
1.2.276.0.7230010.3.1.4.8323329.504.1517875163.224304.png,424110,{},1,0,"{""name"":""rect"",""x"":99,""y"":152,""width"":872,""height"":791}",{},791,rect,872,99,152,/home/dianwen/SIIM_ACR/train/images/1024/dicom/1.2.276.0.7230010.3.1.4.8323329.504.1517875163.224304.png,/home/dianwen/SIIM_ACR/train/images/1024/mask/1.2.276.0.7230010.3.1.4.8323329.504.1517875163.224304.png,0.0,0.0,943,971
1.2.276.0.7230010.3.1.4.8323329.505.1517875163.230835.png,436378,{},1,0,"{""name"":""rect"",""x"":85,""y"":135,""width"":905,""height"":839}",{},839,rect,905,85,135,/home/dianwen/SIIM_ACR/train/images/1024/dicom/1.2.276.0.7230010.3.1.4.8323329.505.1517875163.230835.png,/home/dianwen/SIIM_ACR/train/images/1024/mask/1.2.276.0.7230010.3.1.4.8323329.505.1517875163.230835.png,0.0,0.0,974,990
1.2.276.0.7230010.3.1.4.8323329.506.1517875163.231648.png,403317,{},1,0,"{""name"":""rect"",""x"":127,""y"":92,""width"":763,""height"":726}",{},726,rect,763,127,92,/home/dianwen/SIIM_ACR/train/images/1024/dicom/1.2.276.0.7230010.3.1.4.8323329.506.1517875163.231648.png,/home/dianwen/SIIM_ACR/train/images/1024/mask/1.2.276.0.7230010.3.1.4.8323329.506.1517875163.231648.png,0.01086139678955078,1.0,818,890
1.2.276.0.7230010.3.1.4.8323329.507.1517875163.230787.png,458541,{},1,0,"{""name"":""rect"",""x"":44,""y"":26,""width"":944,""height"":916}",{},916,rect,944,44,26,/home/dianwen/SIIM_ACR/train/images/1024/dicom/1.2.276.0.7230010.3.1.4.8323329.507.1517875163.230787.png,/home/dianwen/SIIM_ACR/train/images/1024/mask/1.2.276.0.7230010.3.1.4.8323329.507.1517875163.230787.png,0.0,0.0,942,988
1.2.276.0.7230010.3.1.4.8323329.508.1517875163.235815.png,433861,{},1,0,"{""name"":""rect"",""x"":95,""y"":109,""width"":840,""height"":851}",{},851,rect,840,95,109,/home/dianwen/SIIM_ACR/train/images/1024/dicom/1.2.276.0.7230010.3.1.4.8323329.508.1517875163.235815.png,/home/dianwen/SIIM_ACR/train/images/1024/mask/1.2.276.0.7230010.3.1.4.8323329.508.1517875163.235815.png,0.0185143481940031,1.0,960,935
1.2.276.0.7230010.3.1.4.8323329.509.1517875163.254033.png,348269,{},1,0,"{""name"":""rect"",""x"":74,""y"":57,""width"":930,""height"":816}",{},816,rect,930,74,57,/home/dianwen/SIIM_ACR/train/images/1024/dicom/1.2.276.0.7230010.3.1.4.8323329.509.1517875163.254033.png,/home/dianwen/SIIM_ACR/train/images/1024/mask/1.2.276.0.7230010.3.1.4.8323329.509.1517875163.254033.png,0.0,0.0,873,1004
1.2.276.0.7230010.3.1.4.8323329.510.1517875163.254033.png,386422,{},1,0,"{""name"":""rect"",""x"":126,""y"":76,""width"":765,""height"":843}",{},843,rect,765,126,76,/home/dianwen/SIIM_ACR/train/images/1024/dicom/1.2.276.0.7230010.3.1.4.8323329.510.1517875163.254033.png,/home/dianwen/SIIM_ACR/train/images/1024/mask/1.2.276.0.7230010.3.1.4.8323329.510.1517875163.254033.png,0.03064727783203125,1.0,919,891
1.2.276.0.7230010.3.1.4.8323329.511.1517875163.256846.png,388428,{},1,0,"{""name"":""rect"",""x"":111,""y"":95,""width"":786,""height"":700}",{},700,rect,786,111,95,/home/dianwen/SIIM_ACR/train/images/1024/dicom/1.2.276.0.7230010.3.1.4.8323329.511.1517875163.256846.png,/home/dianwen/SIIM_ACR/train/images/1024/mask/1.2.276.0.7230010.3.1.4.8323329.511.1517875163.256846.png,0.0,0.0,795,897
1.2.276.0.7230010.3.1.4.8323329.512.1517875163.263758.png,441103,{},1,0,"{""name"":""rect"",""x"":80,""y"":45,""width"":833,""height"":854}",{},854,rect,833,80,45,/home/dianwen/SIIM_ACR/train/images/1024/dicom/1.2.276.0.7230010.3.1.4.8323329.512.1517875163.263758.png,/home/dianwen/SIIM_ACR/train/images/1024/mask/1.2.276.0.7230010.3.1.4.8323329.512.1517875163.263758.png,0.009387969970703123,1.0,899,913
1.2.276.0.7230010.3.1.4.8323329.513.1517875163.267737.png,340851,{},1,0,"{""name"":""rect"",""x"":136,""y"":106,""width"":819,""height"":912}",{},912,rect,819,136,106,/home/dianwen/SIIM_ACR/train/images/1024/dicom/1.2.276.0.7230010.3.1.4.8323329.513.1517875163.267737.png,/home/dianwen/SIIM_ACR/train/images/1024/mask/1.2.276.0.7230010.3.1.4.8323329.513.1517875163.267737.png,0.0,0.0,1018,955
1.2.276.0.7230010.3.1.4.8323329.514.1517875163.270253.png,353321,{},1,0,"{""name"":""rect"",""x"":137,""y"":66,""width"":813,""height"":915}",{},915,rect,813,137,66,/home/dianwen/SIIM_ACR/train/images/1024/dicom/1.2.276.0.7230010.3.1.4.8323329.514.1517875163.270253.png,/home/dianwen/SIIM_ACR/train/images/1024/mask/1.2.276.0.7230010.3.1.4.8323329.514.1517875163.270253.png,0.0,0.0,981,950
1.2.276.0.7230010.3.1.4.8323329.515.1517875163.271050.png,430994,{},1,0,"{""name"":""rect"",""x"":77,""y"":6,""width"":881,""height"":847}",{},847,rect,881,77,6,/home/dianwen/SIIM_ACR/train/images/1024/dicom/1.2.276.0.7230010.3.1.4.8323329.515.1517875163.271050.png,/home/dianwen/SIIM_ACR/train/images/1024/mask/1.2.276.0.7230010.3.1.4.8323329.515.1517875163.271050.png,0.0,0.0,853,958
1.2.276.0.7230010.3.1.4.8323329.516.1517875163.277502.png,438918,{},1,0,"{""name"":""rect"",""x"":87,""y"":37,""width"":804,""height"":811}",{},811,rect,804,87,37,/home/dianwen/SIIM_ACR/train/images/1024/dicom/1.2.276.0.7230010.3.1.4.8323329.516.1517875163.277502.png,/home/dianwen/SIIM_ACR/train/images/1024/mask/1.2.276.0.7230010.3.1.4.8323329.516.1517875163.277502.png,0.0,0.0,848,891
1.2.276.0.7230010.3.1.4.8323329.518.1517875163.282007.png,339509,{},1,0,"{""name"":""rect"",""x"":178,""y"":139,""width"":749,""height"":831}",{},831,rect,749,178,139,/home/dianwen/SIIM_ACR/train/images/1024/dicom/1.2.276.0.7230010.3.1.4.8323329.518.1517875163.282007.png,/home/dianwen/SIIM_ACR/train/images/1024/mask/1.2.276.0.7230010.3.1.4.8323329.518.1517875163.282007.png,0.0,0.0,970,927
1.2.276.0.7230010.3.1.4.8323329.519.1517875163.296150.png,410461,{},1,0,"{""name"":""rect"",""x"":77,""y"":66,""width"":868,""height"":729}",{},729,rect,868,77,66,/home/dianwen/SIIM_ACR/train/images/1024/dicom/1.2.276.0.7230010.3.1.4.8323329.519.1517875163.296150.png,/home/dianwen/SIIM_ACR/train/images/1024/mask/1.2.276.0.7230010.3.1.4.8323329.519.1517875163.296150.png,0.0,0.0,795,945
1.2.276.0.7230010.3.1.4.8323329.520.1517875163.292114.png,420025,{},1,0,"{""name"":""rect"",""x"":101,""y"":69,""width"":801,""height"":761}",{},761,rect,801,101,69,/home/dianwen/SIIM_ACR/train/images/1024/dicom/1.2.276.0.7230010.3.1.4.8323329.520.1517875163.292114.png,/home/dianwen/SIIM_ACR/train/images/1024/mask/1.2.276.0.7230010.3.1.4.8323329.520.1517875163.292114.png,0.0,0.0,830,902
1.2.276.0.7230010.3.1.4.8323329.521.1517875163.304733.png,397976,{},1,0,"{""name"":""rect"",""x"":108,""y"":121,""width"":787,""height"":696}",{},696,rect,787,108,121,/home/dianwen/SIIM_ACR/train/images/1024/dicom/1.2.276.0.7230010.3.1.4.8323329.521.1517875163.304733.png,/home/dianwen/SIIM_ACR/train/images/1024/mask/1.2.276.0.7230010.3.1.4.8323329.521.1517875163.304733.png,0.0,0.0,817,895
1.2.276.0.7230010.3.1.4.8323329.522.1517875163.293103.png,341738,{},1,0,"{""name"":""rect"",""x"":168,""y"":174,""width"":700,""height"":641}",{},641,rect,700,168,174,/home/dianwen/SIIM_ACR/train/images/1024/dicom/1.2.276.0.7230010.3.1.4.8323329.522.1517875163.293103.png,/home/dianwen/SIIM_ACR/train/images/1024/mask/1.2.276.0.7230010.3.1.4.8323329.522.1517875163.293103.png,0.0,0.0,815,868
1.2.276.0.7230010.3.1.4.8323329.523.1517875163.307359.png,421273,{},1,0,"{""name"":""rect"",""x"":126,""y"":170,""width"":895,""height"":851}",{},851,rect,895,126,170,/home/dianwen/SIIM_ACR/train/images/1024/dicom/1.2.276.0.7230010.3.1.4.8323329.523.1517875163.307359.png,/home/dianwen/SIIM_ACR/train/images/1024/mask/1.2.276.0.7230010.3.1.4.8323329.523.1517875163.307359.png,0.0,0.0,1021,1021
1.2.276.0.7230010.3.1.4.8323329.524.1517875163.298894.png,374992,{},1,0,"{""name"":""rect"",""x"":146,""y"":123,""width"":663,""height"":684}",{},684,rect,663,146,123,/home/dianwen/SIIM_ACR/train/images/1024/dicom/1.2.276.0.7230010.3.1.4.8323329.524.1517875163.298894.png,/home/dianwen/SIIM_ACR/train/images/1024/mask/1.2.276.0.7230010.3.1.4.8323329.524.1517875163.298894.png,0.020503997802734368,1.0,807,809
1.2.276.0.7230010.3.1.4.8323329.525.1517875163.309382.png,374674,{},1,0,"{""name"":""rect"",""x"":118,""y"":78,""width"":860,""height"":906}",{},906,rect,860,118,78,/home/dianwen/SIIM_ACR/train/images/1024/dicom/1.2.276.0.7230010.3.1.4.8323329.525.1517875163.309382.png,/home/dianwen/SIIM_ACR/train/images/1024/mask/1.2.276.0.7230010.3.1.4.8323329.525.1517875163.309382.png,0.0,0.0,984,978
1.2.276.0.7230010.3.1.4.8323329.526.1517875163.327181.png,393463,{},1,0,"{""name"":""rect"",""x"":206,""y"":144,""width"":720,""height"":748}",{},748,rect,720,206,144,/home/dianwen/SIIM_ACR/train/images/1024/dicom/1.2.276.0.7230010.3.1.4.8323329.526.1517875163.327181.png,/home/dianwen/SIIM_ACR/train/images/1024/mask/1.2.276.0.7230010.3.1.4.8323329.526.1517875163.327181.png,0.0,0.0,892,926
1.2.276.0.7230010.3.1.4.8323329.527.1517875163.323016.png,426247,{},1,0,"{""name"":""rect"",""x"":83,""y"":44,""width"":808,""height"":711}",{},711,rect,808,83,44,/home/dianwen/SIIM_ACR/train/images/1024/dicom/1.2.276.0.7230010.3.1.4.8323329.527.1517875163.323016.png,/home/dianwen/SIIM_ACR/train/images/1024/mask/1.2.276.0.7230010.3.1.4.8323329.527.1517875163.323016.png,0.0,0.0,755,891
1.2.276.0.7230010.3.1.4.8323329.528.1517875163.318666.png,417848,{},1,0,"{""name"":""rect"",""x"":122,""y"":159,""width"":805,""height"":598}",{},598,rect,805,122,159,/home/dianwen/SIIM_ACR/train/images/1024/dicom/1.2.276.0.7230010.3.1.4.8323329.528.1517875163.318666.png,/home/dianwen/SIIM_ACR/train/images/1024/mask/1.2.276.0.7230010.3.1.4.8323329.528.1517875163.318666.png,0.0,0.0,757,927
1.2.276.0.7230010.3.1.4.8323329.530.1517875163.330394.png,431472,{},1,0,"{""name"":""rect"",""x"":73,""y"":117,""width"":901,""height"":807}",{},807,rect,901,73,117,/home/dianwen/SIIM_ACR/train/images/1024/dicom/1.2.276.0.7230010.3.1.4.8323329.530.1517875163.330394.png,/home/dianwen/SIIM_ACR/train/images/1024/mask/1.2.276.0.7230010.3.1.4.8323329.530.1517875163.330394.png,0.0,0.0,924,974
1.2.276.0.7230010.3.1.4.8323329.531.1517875163.330259.png,314238,{},1,0,"{""name"":""rect"",""x"":71,""y"":165,""width"":839,""height"":793}",{},793,rect,839,71,165,/home/dianwen/SIIM_ACR/train/images/1024/dicom/1.2.276.0.7230010.3.1.4.8323329.531.1517875163.330259.png,/home/dianwen/SIIM_ACR/train/images/1024/mask/1.2.276.0.7230010.3.1.4.8323329.531.1517875163.330259.png,0.0,0.0,958,910
1.2.276.0.7230010.3.1.4.8323329.532.1517875163.335745.png,395847,{},1,0,"{""name"":""rect"",""x"":94,""y"":76,""width"":748,""height"":726}",{},726,rect,748,94,76,/home/dianwen/SIIM_ACR/train/images/1024/dicom/1.2.276.0.7230010.3.1.4.8323329.532.1517875163.335745.png,/home/dianwen/SIIM_ACR/train/images/1024/mask/1.2.276.0.7230010.3.1.4.8323329.532.1517875163.335745.png,0.0,0.0,802,842
1.2.276.0.7230010.3.1.4.8323329.533.1517875163.335668.png,438675,{},1,0,"{""name"":""rect"",""x"":57,""y"":165,""width"":870,""height"":856}",{},856,rect,870,57,165,/home/dianwen/SIIM_ACR/train/images/1024/dicom/1.2.276.0.7230010.3.1.4.8323329.533.1517875163.335668.png,/home/dianwen/SIIM_ACR/train/images/1024/mask/1.2.276.0.7230010.3.1.4.8323329.533.1517875163.335668.png,0.0095062255859375,1.0,1021,927
1.2.276.0.7230010.3.1.4.8323329.535.1517875163.334627.png,373696,{},1,0,"{""name"":""rect"",""x"":197,""y"":107,""width"":703,""height"":827}",{},827,rect,703,197,107,/home/dianwen/SIIM_ACR/train/images/1024/dicom/1.2.276.0.7230010.3.1.4.8323329.535.1517875163.334627.png,/home/dianwen/SIIM_ACR/train/images/1024/mask/1.2.276.0.7230010.3.1.4.8323329.535.1517875163.334627.png,0.0,0.0,934,900
1.2.276.0.7230010.3.1.4.8323329.536.1517875163.343518.png,313425,{},1,0,"{""name"":""rect"",""x"":157,""y"":103,""width"":844,""height"":732}",{},732,rect,844,157,103,/home/dianwen/SIIM_ACR/train/images/1024/dicom/1.2.276.0.7230010.3.1.4.8323329.536.1517875163.343518.png,/home/dianwen/SIIM_ACR/train/images/1024/mask/1.2.276.0.7230010.3.1.4.8323329.536.1517875163.343518.png,0.0041561126708984375,1.0,835,1001
1.2.276.0.7230010.3.1.4.8323329.538.1517875163.339559.png,441886,{},1,0,"{""name"":""rect"",""x"":134,""y"":120,""width"":852,""height"":901}",{},901,rect,852,134,120,/home/dianwen/SIIM_ACR/train/images/1024/dicom/1.2.276.0.7230010.3.1.4.8323329.538.1517875163.339559.png,/home/dianwen/SIIM_ACR/train/images/1024/mask/1.2.276.0.7230010.3.1.4.8323329.538.1517875163.339559.png,0.0,0.0,1021,986
1.2.276.0.7230010.3.1.4.8323329.539.1517875163.351603.png,372663,{},1,0,"{""name"":""rect"",""x"":42,""y"":86,""width"":863,""height"":845}",{},845,rect,863,42,86,/home/dianwen/SIIM_ACR/train/images/1024/dicom/1.2.276.0.7230010.3.1.4.8323329.539.1517875163.351603.png,/home/dianwen/SIIM_ACR/train/images/1024/mask/1.2.276.0.7230010.3.1.4.8323329.539.1517875163.351603.png,0.0,0.0,931,905
1.2.276.0.7230010.3.1.4.8323329.540.1517875163.355534.png,408806,{},1,0,"{""name"":""rect"",""x"":43,""y"":107,""width"":837,""height"":611}",{},611,rect,837,43,107,/home/dianwen/SIIM_ACR/train/images/1024/dicom/1.2.276.0.7230010.3.1.4.8323329.540.1517875163.355534.png,/home/dianwen/SIIM_ACR/train/images/1024/mask/1.2.276.0.7230010.3.1.4.8323329.540.1517875163.355534.png,0.0,0.0,718,880
1.2.276.0.7230010.3.1.4.8323329.541.1517875163.358447.png,330619,{},1,0,"{""name"":""rect"",""x"":97,""y"":137,""width"":778,""height"":639}",{},639,rect,778,97,137,/home/dianwen/SIIM_ACR/train/images/1024/dicom/1.2.276.0.7230010.3.1.4.8323329.541.1517875163.358447.png,/home/dianwen/SIIM_ACR/train/images/1024/mask/1.2.276.0.7230010.3.1.4.8323329.541.1517875163.358447.png,0.0,0.0,776,875
1.2.276.0.7230010.3.1.4.8323329.542.1517875163.362270.png,364301,{},1,0,"{""name"":""rect"",""x"":240,""y"":271,""width"":677,""height"":741}",{},741,rect,677,240,271,/home/dianwen/SIIM_ACR/train/images/1024/dicom/1.2.276.0.7230010.3.1.4.8323329.542.1517875163.362270.png,/home/dianwen/SIIM_ACR/train/images/1024/mask/1.2.276.0.7230010.3.1.4.8323329.542.1517875163.362270.png,0.0,0.0,1012,917
1.2.276.0.7230010.3.1.4.8323329.543.1517875163.370062.png,341416,{},1,0,"{""name"":""rect"",""x"":196,""y"":63,""width"":685,""height"":933}",{},933,rect,685,196,63,/home/dianwen/SIIM_ACR/train/images/1024/dicom/1.2.276.0.7230010.3.1.4.8323329.543.1517875163.370062.png,/home/dianwen/SIIM_ACR/train/images/1024/mask/1.2.276.0.7230010.3.1.4.8323329.543.1517875163.370062.png,0.003176689147949219,1.0,996,881
1.2.276.0.7230010.3.1.4.8323329.544.1517875163.377294.png,407677,{},1,0,"{""name"":""rect"",""x"":91,""y"":123,""width"":801,""height"":833}",{},833,rect,801,91,123,/home/dianwen/SIIM_ACR/train/images/1024/dicom/1.2.276.0.7230010.3.1.4.8323329.544.1517875163.377294.png,/home/dianwen/SIIM_ACR/train/images/1024/mask/1.2.276.0.7230010.3.1.4.8323329.544.1517875163.377294.png,0.0,0.0,956,892
1.2.276.0.7230010.3.1.4.8323329.545.1517875163.377721.png,418400,{},1,0,"{""name"":""rect"",""x"":152,""y"":85,""width"":808,""height"":762}",{},762,rect,808,152,85,/home/dianwen/SIIM_ACR/train/images/1024/dicom/1.2.276.0.7230010.3.1.4.8323329.545.1517875163.377721.png,/home/dianwen/SIIM_ACR/train/images/1024/mask/1.2.276.0.7230010.3.1.4.8323329.545.1517875163.377721.png,0.0,0.0,847,960
1.2.276.0.7230010.3.1.4.8323329.546.1517875163.387079.png,367155,{},1,0,"{""name"":""rect"",""x"":68,""y"":63,""width"":879,""height"":835}",{},835,rect,879,68,63,/home/dianwen/SIIM_ACR/train/images/1024/dicom/1.2.276.0.7230010.3.1.4.8323329.546.1517875163.387079.png,/home/dianwen/SIIM_ACR/train/images/1024/mask/1.2.276.0.7230010.3.1.4.8323329.546.1517875163.387079.png,0.0,0.0,898,947
1.2.276.0.7230010.3.1.4.8323329.547.1517875163.379326.png,314603,{},1,0,"{""name"":""rect"",""x"":146,""y"":120,""width"":728,""height"":740}",{},740,rect,728,146,120,/home/dianwen/SIIM_ACR/train/images/1024/dicom/1.2.276.0.7230010.3.1.4.8323329.547.1517875163.379326.png,/home/dianwen/SIIM_ACR/train/images/1024/mask/1.2.276.0.7230010.3.1.4.8323329.547.1517875163.379326.png,0.0,0.0,860,874
1.2.276.0.7230010.3.1.4.8323329.548.1517875163.391746.png,442671,{},1,0,"{""name"":""rect"",""x"":52,""y"":35,""width"":916,""height"":767}",{},767,rect,916,52,35,/home/dianwen/SIIM_ACR/train/images/1024/dicom/1.2.276.0.7230010.3.1.4.8323329.548.1517875163.391746.png,/home/dianwen/SIIM_ACR/train/images/1024/mask/1.2.276.0.7230010.3.1.4.8323329.548.1517875163.391746.png,0.0,0.0,802,968
1.2.276.0.7230010.3.1.4.8323329.549.1517875163.388922.png,416281,{},1,0,"{""name"":""rect"",""x"":194,""y"":25,""width"":770,""height"":824}",{},824,rect,770,194,25,/home/dianwen/SIIM_ACR/train/images/1024/dicom/1.2.276.0.7230010.3.1.4.8323329.549.1517875163.388922.png,/home/dianwen/SIIM_ACR/train/images/1024/mask/1.2.276.0.7230010.3.1.4.8323329.549.1517875163.388922.png,0.0,0.0,849,964
1.2.276.0.7230010.3.1.4.8323329.550.1517875163.394533.png,424907,{},1,0,"{""name"":""rect"",""x"":48,""y"":95,""width"":803,""height"":686}",{},686,rect,803,48,95,/home/dianwen/SIIM_ACR/train/images/1024/dicom/1.2.276.0.7230010.3.1.4.8323329.550.1517875163.394533.png,/home/dianwen/SIIM_ACR/train/images/1024/mask/1.2.276.0.7230010.3.1.4.8323329.550.1517875163.394533.png,0.002264022827148437,1.0,781,851
1.2.276.0.7230010.3.1.4.8323329.551.1517875163.393692.png,340911,{},1,0,"{""name"":""rect"",""x"":102,""y"":179,""width"":834,""height"":790}",{},790,rect,834,102,179,/home/dianwen/SIIM_ACR/train/images/1024/dicom/1.2.276.0.7230010.3.1.4.8323329.551.1517875163.393692.png,/home/dianwen/SIIM_ACR/train/images/1024/mask/1.2.276.0.7230010.3.1.4.8323329.551.1517875163.393692.png,0.07106416672468185,1.0,969,936
1.2.276.0.7230010.3.1.4.8323329.552.1517875163.403094.png,412342,{},1,0,"{""name"":""rect"",""x"":62,""y"":130,""width"":889,""height"":861}",{},861,rect,889,62,130,/home/dianwen/SIIM_ACR/train/images/1024/dicom/1.2.276.0.7230010.3.1.4.8323329.552.1517875163.403094.png,/home/dianwen/SIIM_ACR/train/images/1024/mask/1.2.276.0.7230010.3.1.4.8323329.552.1517875163.403094.png,0.0,0.0,991,951
1.2.276.0.7230010.3.1.4.8323329.553.1517875163.407125.png,380052,{},1,0,"{""name"":""rect"",""x"":156,""y"":155,""width"":739,""height"":712}",{},712,rect,739,156,155,/home/dianwen/SIIM_ACR/train/images/1024/dicom/1.2.276.0.7230010.3.1.4.8323329.553.1517875163.407125.png,/home/dianwen/SIIM_ACR/train/images/1024/mask/1.2.276.0.7230010.3.1.4.8323329.553.1517875163.407125.png,0.0029754638671875,1.0,867,895
1.2.276.0.7230010.3.1.4.8323329.556.1517875163.421242.png,347604,{},1,0,"{""name"":""rect"",""x"":174,""y"":118,""width"":818,""height"":809}",{},809,rect,818,174,118,/home/dianwen/SIIM_ACR/train/images/1024/dicom/1.2.276.0.7230010.3.1.4.8323329.556.1517875163.421242.png,/home/dianwen/SIIM_ACR/train/images/1024/mask/1.2.276.0.7230010.3.1.4.8323329.556.1517875163.421242.png,0.014666557312011719,1.0,927,992
1.2.276.0.7230010.3.1.4.8323329.557.1517875163.423293.png,413756,{},1,0,"{""name"":""rect"",""x"":177,""y"":95,""width"":723,""height"":697}",{},697,rect,723,177,95,/home/dianwen/SIIM_ACR/train/images/1024/dicom/1.2.276.0.7230010.3.1.4.8323329.557.1517875163.423293.png,/home/dianwen/SIIM_ACR/train/images/1024/mask/1.2.276.0.7230010.3.1.4.8323329.557.1517875163.423293.png,0.0,0.0,792,900
1.2.276.0.7230010.3.1.4.8323329.558.1517875163.430896.png,439839,{},1,0,"{""name"":""rect"",""x"":103,""y"":76,""width"":836,""height"":942}",{},942,rect,836,103,76,/home/dianwen/SIIM_ACR/train/images/1024/dicom/1.2.276.0.7230010.3.1.4.8323329.558.1517875163.430896.png,/home/dianwen/SIIM_ACR/train/images/1024/mask/1.2.276.0.7230010.3.1.4.8323329.558.1517875163.430896.png,0.0039310455322265625,1.0,1018,939
1.2.276.0.7230010.3.1.4.8323329.559.1517875163.427432.png,446296,{},1,0,"{""name"":""rect"",""x"":136,""y"":187,""width"":643,""height"":778}",{},778,rect,643,136,187,/home/dianwen/SIIM_ACR/train/images/1024/dicom/1.2.276.0.7230010.3.1.4.8323329.559.1517875163.427432.png,/home/dianwen/SIIM_ACR/train/images/1024/mask/1.2.276.0.7230010.3.1.4.8323329.559.1517875163.427432.png,0.011286735534667969,1.0,965,779
1.2.276.0.7230010.3.1.4.8323329.560.1517875163.435334.png,434159,{},1,0,"{""name"":""rect"",""x"":140,""y"":42,""width"":702,""height"":642}",{},642,rect,702,140,42,/home/dianwen/SIIM_ACR/train/images/1024/dicom/1.2.276.0.7230010.3.1.4.8323329.560.1517875163.435334.png,/home/dianwen/SIIM_ACR/train/images/1024/mask/1.2.276.0.7230010.3.1.4.8323329.560.1517875163.435334.png,0.01116180419921875,1.0,684,842
1.2.276.0.7230010.3.1.4.8323329.561.1517875163.435980.png,352637,{},1,0,"{""name"":""rect"",""x"":95,""y"":29,""width"":837,""height"":736}",{},736,rect,837,95,29,/home/dianwen/SIIM_ACR/train/images/1024/dicom/1.2.276.0.7230010.3.1.4.8323329.561.1517875163.435980.png,/home/dianwen/SIIM_ACR/train/images/1024/mask/1.2.276.0.7230010.3.1.4.8323329.561.1517875163.435980.png,0.0,0.0,765,932
1.2.276.0.7230010.3.1.4.8323329.562.1517875163.442377.png,370632,{},1,0,"{""name"":""rect"",""x"":156,""y"":19,""width"":797,""height"":938}",{},938,rect,797,156,19,/home/dianwen/SIIM_ACR/train/images/1024/dicom/1.2.276.0.7230010.3.1.4.8323329.562.1517875163.442377.png,/home/dianwen/SIIM_ACR/train/images/1024/mask/1.2.276.0.7230010.3.1.4.8323329.562.1517875163.442377.png,0.0,0.0,957,953
1.2.276.0.7230010.3.1.4.8323329.563.1517875163.451169.png,361958,{},1,0,"{""name"":""rect"",""x"":127,""y"":34,""width"":879,""height"":984}",{},984,rect,879,127,34,/home/dianwen/SIIM_ACR/train/images/1024/dicom/1.2.276.0.7230010.3.1.4.8323329.563.1517875163.451169.png,/home/dianwen/SIIM_ACR/train/images/1024/mask/1.2.276.0.7230010.3.1.4.8323329.563.1517875163.451169.png,0.0,0.0,1018,1006
1.2.276.0.7230010.3.1.4.8323329.564.1517875163.450861.png,426749,{},1,0,"{""name"":""rect"",""x"":128,""y"":58,""width"":796,""height"":950}",{},950,rect,796,128,58,/home/dianwen/SIIM_ACR/train/images/1024/dicom/1.2.276.0.7230010.3.1.4.8323329.564.1517875163.450861.png,/home/dianwen/SIIM_ACR/train/images/1024/mask/1.2.276.0.7230010.3.1.4.8323329.564.1517875163.450861.png,0.0,0.0,1008,924
1.2.276.0.7230010.3.1.4.8323329.565.1517875163.456361.png,431013,{},1,0,"{""name"":""rect"",""x"":41,""y"":58,""width"":932,""height"":731}",{},731,rect,932,41,58,/home/dianwen/SIIM_ACR/train/images/1024/dicom/1.2.276.0.7230010.3.1.4.8323329.565.1517875163.456361.png,/home/dianwen/SIIM_ACR/train/images/1024/mask/1.2.276.0.7230010.3.1.4.8323329.565.1517875163.456361.png,0.0,0.0,789,973
1.2.276.0.7230010.3.1.4.8323329.566.1517875163.459814.png,435265,{},1,0,"{""name"":""rect"",""x"":83,""y"":110,""width"":854,""height"":845}",{},845,rect,854,83,110,/home/dianwen/SIIM_ACR/train/images/1024/dicom/1.2.276.0.7230010.3.1.4.8323329.566.1517875163.459814.png,/home/dianwen/SIIM_ACR/train/images/1024/mask/1.2.276.0.7230010.3.1.4.8323329.566.1517875163.459814.png,0.0,0.0,955,937
1.2.276.0.7230010.3.1.4.8323329.567.1517875163.478398.png,413962,{},1,0,"{""name"":""rect"",""x"":121,""y"":67,""width"":776,""height"":740}",{},740,rect,776,121,67,/home/dianwen/SIIM_ACR/train/images/1024/dicom/1.2.276.0.7230010.3.1.4.8323329.567.1517875163.478398.png,/home/dianwen/SIIM_ACR/train/images/1024/mask/1.2.276.0.7230010.3.1.4.8323329.567.1517875163.478398.png,0.01422679517418146,1.0,807,897
1.2.276.0.7230010.3.1.4.8323329.568.1517875163.478837.png,298087,{},1,0,"{""name"":""rect"",""x"":188,""y"":69,""width"":805,""height"":898}",{},898,rect,805,188,69,/home/dianwen/SIIM_ACR/train/images/1024/dicom/1.2.276.0.7230010.3.1.4.8323329.568.1517875163.478837.png,/home/dianwen/SIIM_ACR/train/images/1024/mask/1.2.276.0.7230010.3.1.4.8323329.568.1517875163.478837.png,0.0,0.0,967,993
1.2.276.0.7230010.3.1.4.8323329.569.1517875163.490558.png,402816,{},1,0,"{""name"":""rect"",""x"":130,""y"":100,""width"":745,""height"":723}",{},723,rect,745,130,100,/home/dianwen/SIIM_ACR/train/images/1024/dicom/1.2.276.0.7230010.3.1.4.8323329.569.1517875163.490558.png,/home/dianwen/SIIM_ACR/train/images/1024/mask/1.2.276.0.7230010.3.1.4.8323329.569.1517875163.490558.png,0.0,0.0,823,875
1.2.276.0.7230010.3.1.4.8323329.570.1517875163.482490.png,355114,{},1,0,"{""name"":""rect"",""x"":48,""y"":120,""width"":911,""height"":762}",{},762,rect,911,48,120,/home/dianwen/SIIM_ACR/train/images/1024/dicom/1.2.276.0.7230010.3.1.4.8323329.570.1517875163.482490.png,/home/dianwen/SIIM_ACR/train/images/1024/mask/1.2.276.0.7230010.3.1.4.8323329.570.1517875163.482490.png,0.0,0.0,882,959
1.2.276.0.7230010.3.1.4.8323329.571.1517875163.494518.png,377706,{},1,0,"{""name"":""rect"",""x"":14,""y"":113,""width"":976,""height"":814}",{},814,rect,976,14,113,/home/dianwen/SIIM_ACR/train/images/1024/dicom/1.2.276.0.7230010.3.1.4.8323329.571.1517875163.494518.png,/home/dianwen/SIIM_ACR/train/images/1024/mask/1.2.276.0.7230010.3.1.4.8323329.571.1517875163.494518.png,0.0,0.0,927,990
1.2.276.0.7230010.3.1.4.8323329.572.1517875163.499069.png,364563,{},1,0,"{""name"":""rect"",""x"":65,""y"":230,""width"":754,""height"":715}",{},715,rect,754,65,230,/home/dianwen/SIIM_ACR/train/images/1024/dicom/1.2.276.0.7230010.3.1.4.8323329.572.1517875163.499069.png,/home/dianwen/SIIM_ACR/train/images/1024/mask/1.2.276.0.7230010.3.1.4.8323329.572.1517875163.499069.png,0.0,0.0,945,819
1.2.276.0.7230010.3.1.4.8323329.573.1517875163.501062.png,438867,{},1,0,"{""name"":""rect"",""x"":123,""y"":115,""width"":807,""height"":795}",{},795,rect,807,123,115,/home/dianwen/SIIM_ACR/train/images/1024/dicom/1.2.276.0.7230010.3.1.4.8323329.573.1517875163.501062.png,/home/dianwen/SIIM_ACR/train/images/1024/mask/1.2.276.0.7230010.3.1.4.8323329.573.1517875163.501062.png,0.0038738250732421892,1.0,910,930
1.2.276.0.7230010.3.1.4.8323329.574.1517875163.503792.png,344958,{},1,0,"{""name"":""rect"",""x"":147,""y"":127,""width"":854,""height"":872}",{},872,rect,854,147,127,/home/dianwen/SIIM_ACR/train/images/1024/dicom/1.2.276.0.7230010.3.1.4.8323329.574.1517875163.503792.png,/home/dianwen/SIIM_ACR/train/images/1024/mask/1.2.276.0.7230010.3.1.4.8323329.574.1517875163.503792.png,0.11175155639648438,1.0,999,1001
1.2.276.0.7230010.3.1.4.8323329.575.1517875163.509769.png,396633,{},1,0,"{""name"":""rect"",""x"":146,""y"":60,""width"":746,""height"":726}",{},726,rect,746,146,60,/home/dianwen/SIIM_ACR/train/images/1024/dicom/1.2.276.0.7230010.3.1.4.8323329.575.1517875163.509769.png,/home/dianwen/SIIM_ACR/train/images/1024/mask/1.2.276.0.7230010.3.1.4.8323329.575.1517875163.509769.png,0.0,0.0,786,892
1.2.276.0.7230010.3.1.4.8323329.576.1517875163.513917.png,355113,{},1,0,"{""name"":""rect"",""x"":84,""y"":99,""width"":871,""height"":839}",{},839,rect,871,84,99,/home/dianwen/SIIM_ACR/train/images/1024/dicom/1.2.276.0.7230010.3.1.4.8323329.576.1517875163.513917.png,/home/dianwen/SIIM_ACR/train/images/1024/mask/1.2.276.0.7230010.3.1.4.8323329.576.1517875163.513917.png,0.0,0.0,938,955
1.2.276.0.7230010.3.1.4.8323329.577.1517875163.520080.png,356225,{},1,0,"{""name"":""rect"",""x"":26,""y"":147,""width"":988,""height"":838}",{},838,rect,988,26,147,/home/dianwen/SIIM_ACR/train/images/1024/dicom/1.2.276.0.7230010.3.1.4.8323329.577.1517875163.520080.png,/home/dianwen/SIIM_ACR/train/images/1024/mask/1.2.276.0.7230010.3.1.4.8323329.577.1517875163.520080.png,0.0,0.0,985,1014
1.2.276.0.7230010.3.1.4.8323329.578.1517875163.522743.png,366742,{},1,0,"{""name"":""rect"",""x"":49,""y"":110,""width"":639,""height"":793}",{},793,rect,639,49,110,/home/dianwen/SIIM_ACR/train/images/1024/dicom/1.2.276.0.7230010.3.1.4.8323329.578.1517875163.522743.png,/home/dianwen/SIIM_ACR/train/images/1024/mask/1.2.276.0.7230010.3.1.4.8323329.578.1517875163.522743.png,0.05114555358886719,1.0,903,688
1.2.276.0.7230010.3.1.4.8323329.579.1517875163.536413.png,358785,{},1,0,"{""name"":""rect"",""x"":145,""y"":82,""width"":814,""height"":939}",{},939,rect,814,145,82,/home/dianwen/SIIM_ACR/train/images/1024/dicom/1.2.276.0.7230010.3.1.4.8323329.579.1517875163.536413.png,/home/dianwen/SIIM_ACR/train/images/1024/mask/1.2.276.0.7230010.3.1.4.8323329.579.1517875163.536413.png,0.0,0.0,1021,959
1.2.276.0.7230010.3.1.4.8323329.1000.1517875165.878027.png,387183,{},1,0,"{""name"":""rect"",""x"":68,""y"":12,""width"":824,""height"":999}",{},999,rect,824,68,12,/home/dianwen/SIIM_ACR/train/images/1024/dicom/1.2.276.0.7230010.3.1.4.8323329.1000.1517875165.878027.png,/home/dianwen/SIIM_ACR/train/images/1024/mask/1.2.276.0.7230010.3.1.4.8323329.1000.1517875165.878027.png,0.0,0.0,1011,892
1.2.276.0.7230010.3.1.4.8323329.1001.1517875165.882090.png,350026,{},1,0,"{""name"":""rect"",""x"":116,""y"":131,""width"":802,""height"":689}",{},689,rect,802,116,131,/home/dianwen/SIIM_ACR/train/images/1024/dicom/1.2.276.0.7230010.3.1.4.8323329.1001.1517875165.882090.png,/home/dianwen/SIIM_ACR/train/images/1024/mask/1.2.276.0.7230010.3.1.4.8323329.1001.1517875165.882090.png,0.0,0.0,820,918
1.2.276.0.7230010.3.1.4.8323329.1002.1517875165.878183.png,428444,{},1,0,"{""name"":""rect"",""x"":10,""y"":61,""width"":965,""height"":804}",{},804,rect,965,10,61,/home/dianwen/SIIM_ACR/train/images/1024/dicom/1.2.276.0.7230010.3.1.4.8323329.1002.1517875165.878183.png,/home/dianwen/SIIM_ACR/train/images/1024/mask/1.2.276.0.7230010.3.1.4.8323329.1002.1517875165.878183.png,0.0,0.0,865,975
1.2.276.0.7230010.3.1.4.8323329.1003.1517875165.884550.png,426554,{},1,0,"{""name"":""rect"",""x"":116,""y"":23,""width"":784,""height"":779}",{},779,rect,784,116,23,/home/dianwen/SIIM_ACR/train/images/1024/dicom/1.2.276.0.7230010.3.1.4.8323329.1003.1517875165.884550.png,/home/dianwen/SIIM_ACR/train/images/1024/mask/1.2.276.0.7230010.3.1.4.8323329.1003.1517875165.884550.png,0.0,0.0,802,900
1.2.276.0.7230010.3.1.4.8323329.1006.1517875165.891341.png,403318,{},1,0,"{""name"":""rect"",""x"":156,""y"":36,""width"":691,""height"":840}",{},840,rect,691,156,36,/home/dianwen/SIIM_ACR/train/images/1024/dicom/1.2.276.0.7230010.3.1.4.8323329.1006.1517875165.891341.png,/home/dianwen/SIIM_ACR/train/images/1024/mask/1.2.276.0.7230010.3.1.4.8323329.1006.1517875165.891341.png,0.0,0.0,876,847
1.2.276.0.7230010.3.1.4.8323329.1008.1517875165.893982.png,367334,{},1,0,"{""name"":""rect"",""x"":42,""y"":21,""width"":880,""height"":697}",{},697,rect,880,42,21,/home/dianwen/SIIM_ACR/train/images/1024/dicom/1.2.276.0.7230010.3.1.4.8323329.1008.1517875165.893982.png,/home/dianwen/SIIM_ACR/train/images/1024/mask/1.2.276.0.7230010.3.1.4.8323329.1008.1517875165.893982.png,0.0,0.0,718,922
1.2.276.0.7230010.3.1.4.8323329.1009.1517875165.901384.png,447342,{},1,0,"{""name"":""rect"",""x"":134,""y"":89,""width"":719,""height"":809}",{},809,rect,719,134,89,/home/dianwen/SIIM_ACR/train/images/1024/dicom/1.2.276.0.7230010.3.1.4.8323329.1009.1517875165.901384.png,/home/dianwen/SIIM_ACR/train/images/1024/mask/1.2.276.0.7230010.3.1.4.8323329.1009.1517875165.901384.png,0.0,0.0,898,853
1.2.276.0.7230010.3.1.4.8323329.1010.1517875165.904185.png,437782,{},1,0,"{""name"":""rect"",""x"":91,""y"":54,""width"":877,""height"":912}",{},912,rect,877,91,54,/home/dianwen/SIIM_ACR/train/images/1024/dicom/1.2.276.0.7230010.3.1.4.8323329.1010.1517875165.904185.png,/home/dianwen/SIIM_ACR/train/images/1024/mask/1.2.276.0.7230010.3.1.4.8323329.1010.1517875165.904185.png,0.0,0.0,966,968
1.2.276.0.7230010.3.1.4.8323329.1011.1517875165.904974.png,333774,{},1,0,"{""name"":""rect"",""x"":189,""y"":19,""width"":831,""height"":896}",{},896,rect,831,189,19,/home/dianwen/SIIM_ACR/train/images/1024/dicom/1.2.276.0.7230010.3.1.4.8323329.1011.1517875165.904974.png,/home/dianwen/SIIM_ACR/train/images/1024/mask/1.2.276.0.7230010.3.1.4.8323329.1011.1517875165.904974.png,0.0,0.0,915,1020
1.2.276.0.7230010.3.1.4.8323329.1012.1517875165.910041.png,382849,{},1,0,"{""name"":""rect"",""x"":153,""y"":186,""width"":718,""height"":709}",{},709,rect,718,153,186,/home/dianwen/SIIM_ACR/train/images/1024/dicom/1.2.276.0.7230010.3.1.4.8323329.1012.1517875165.910041.png,/home/dianwen/SIIM_ACR/train/images/1024/mask/1.2.276.0.7230010.3.1.4.8323329.1012.1517875165.910041.png,0.005959510803222656,1.0,895,871
1.2.276.0.7230010.3.1.4.8323329.1013.1517875165.907198.png,409605,{},1,0,"{""name"":""rect"",""x"":136,""y"":76,""width"":729,""height"":749}",{},749,rect,729,136,76,/home/dianwen/SIIM_ACR/train/images/1024/dicom/1.2.276.0.7230010.3.1.4.8323329.1013.1517875165.907198.png,/home/dianwen/SIIM_ACR/train/images/1024/mask/1.2.276.0.7230010.3.1.4.8323329.1013.1517875165.907198.png,0.0,0.0,825,865
1.2.276.0.7230010.3.1.4.8323329.1014.1517875165.916103.png,347899,{},1,0,"{""name"":""rect"",""x"":208,""y"":111,""width"":750,""height"":811}",{},811,rect,750,208,111,/home/dianwen/SIIM_ACR/train/images/1024/dicom/1.2.276.0.7230010.3.1.4.8323329.1014.1517875165.916103.png,/home/dianwen/SIIM_ACR/train/images/1024/mask/1.2.276.0.7230010.3.1.4.8323329.1014.1517875165.916103.png,0.0,0.0,922,958
1.2.276.0.7230010.3.1.4.8323329.1015.1517875165.916103.png,418286,{},1,0,"{""name"":""rect"",""x"":89,""y"":103,""width"":812,""height"":759}",{},759,rect,812,89,103,/home/dianwen/SIIM_ACR/train/images/1024/dicom/1.2.276.0.7230010.3.1.4.8323329.1015.1517875165.916103.png,/home/dianwen/SIIM_ACR/train/images/1024/mask/1.2.276.0.7230010.3.1.4.8323329.1015.1517875165.916103.png,0.0,0.0,862,901
1.2.276.0.7230010.3.1.4.8323329.1016.1517875165.922067.png,329109,{},1,0,"{""name"":""rect"",""x"":86,""y"":144,""width"":925,""height"":724}",{},724,rect,925,86,144,/home/dianwen/SIIM_ACR/train/images/1024/dicom/1.2.276.0.7230010.3.1.4.8323329.1016.1517875165.922067.png,/home/dianwen/SIIM_ACR/train/images/1024/mask/1.2.276.0.7230010.3.1.4.8323329.1016.1517875165.922067.png,0.0,0.0,868,1011
1.2.276.0.7230010.3.1.4.8323329.1017.1517875165.920291.png,352970,{},1,0,"{""name"":""rect"",""x"":148,""y"":145,""width"":700,""height"":596}",{},596,rect,700,148,145,/home/dianwen/SIIM_ACR/train/images/1024/dicom/1.2.276.0.7230010.3.1.4.8323329.1017.1517875165.920291.png,/home/dianwen/SIIM_ACR/train/images/1024/mask/1.2.276.0.7230010.3.1.4.8323329.1017.1517875165.920291.png,0.007236480712890625,1.0,741,848
1.2.276.0.7230010.3.1.4.8323329.1018.1517875165.930636.png,322533,{},1,0,"{""name"":""rect"",""x"":123,""y"":99,""width"":760,""height"":860}",{},860,rect,760,123,99,/home/dianwen/SIIM_ACR/train/images/1024/dicom/1.2.276.0.7230010.3.1.4.8323329.1018.1517875165.930636.png,/home/dianwen/SIIM_ACR/train/images/1024/mask/1.2.276.0.7230010.3.1.4.8323329.1018.1517875165.930636.png,0.0,0.0,959,883
1.2.276.0.7230010.3.1.4.8323329.1019.1517875165.936673.png,381355,{},1,0,"{""name"":""rect"",""x"":102,""y"":49,""width"":751,""height"":868}",{},868,rect,751,102,49,/home/dianwen/SIIM_ACR/train/images/1024/dicom/1.2.276.0.7230010.3.1.4.8323329.1019.1517875165.936673.png,/home/dianwen/SIIM_ACR/train/images/1024/mask/1.2.276.0.7230010.3.1.4.8323329.1019.1517875165.936673.png,0.0,0.0,917,853
1.2.276.0.7230010.3.1.4.8323329.1020.1517875165.935324.png,364324,{},1,0,"{""name"":""rect"",""x"":123,""y"":72,""width"":757,""height"":818}",{},818,rect,757,123,72,/home/dianwen/SIIM_ACR/train/images/1024/dicom/1.2.276.0.7230010.3.1.4.8323329.1020.1517875165.935324.png,/home/dianwen/SIIM_ACR/train/images/1024/mask/1.2.276.0.7230010.3.1.4.8323329.1020.1517875165.935324.png,0.0,0.0,890,880
1.2.276.0.7230010.3.1.4.8323329.1021.1517875165.948219.png,391687,{},1,0,"{""name"":""rect"",""x"":51,""y"":55,""width"":848,""height"":924}",{},924,rect,848,51,55,/home/dianwen/SIIM_ACR/train/images/1024/dicom/1.2.276.0.7230010.3.1.4.8323329.1021.1517875165.948219.png,/home/dianwen/SIIM_ACR/train/images/1024/mask/1.2.276.0.7230010.3.1.4.8323329.1021.1517875165.948219.png,0.0,0.0,979,899
1.2.276.0.7230010.3.1.4.8323329.1022.1517875165.946423.png,464263,{},1,0,"{""name"":""rect"",""x"":75,""y"":59,""width"":842,""height"":811}",{},811,rect,842,75,59,/home/dianwen/SIIM_ACR/train/images/1024/dicom/1.2.276.0.7230010.3.1.4.8323329.1022.1517875165.946423.png,/home/dianwen/SIIM_ACR/train/images/1024/mask/1.2.276.0.7230010.3.1.4.8323329.1022.1517875165.946423.png,0.0038404464721679688,1.0,870,917
1.2.276.0.7230010.3.1.4.8323329.1023.1517875165.944494.png,379538,{},1,0,"{""name"":""rect"",""x"":139,""y"":95,""width"":831,""height"":786}",{},786,rect,831,139,95,/home/dianwen/SIIM_ACR/train/images/1024/dicom/1.2.276.0.7230010.3.1.4.8323329.1023.1517875165.944494.png,/home/dianwen/SIIM_ACR/train/images/1024/mask/1.2.276.0.7230010.3.1.4.8323329.1023.1517875165.944494.png,0.004377365112304688,1.0,881,970
1.2.276.0.7230010.3.1.4.8323329.1024.1517875165.953650.png,381660,{},1,0,"{""name"":""rect"",""x"":100,""y"":70,""width"":837,""height"":867}",{},867,rect,837,100,70,/home/dianwen/SIIM_ACR/train/images/1024/dicom/1.2.276.0.7230010.3.1.4.8323329.1024.1517875165.953650.png,/home/dianwen/SIIM_ACR/train/images/1024/mask/1.2.276.0.7230010.3.1.4.8323329.1024.1517875165.953650.png,0.0,0.0,937,937
1.2.276.0.7230010.3.1.4.8323329.1025.1517875165.962119.png,429668,{},1,0,"{""name"":""rect"",""x"":89,""y"":60,""width"":795,""height"":818}",{},818,rect,795,89,60,/home/dianwen/SIIM_ACR/train/images/1024/dicom/1.2.276.0.7230010.3.1.4.8323329.1025.1517875165.962119.png,/home/dianwen/SIIM_ACR/train/images/1024/mask/1.2.276.0.7230010.3.1.4.8323329.1025.1517875165.962119.png,0.0,0.0,878,884
1.2.276.0.7230010.3.1.4.8323329.1026.1517875165.965008.png,413852,{},1,0,"{""name"":""rect"",""x"":114,""y"":111,""width"":777,""height"":686}",{},686,rect,777,114,111,/home/dianwen/SIIM_ACR/train/images/1024/dicom/1.2.276.0.7230010.3.1.4.8323329.1026.1517875165.965008.png,/home/dianwen/SIIM_ACR/train/images/1024/mask/1.2.276.0.7230010.3.1.4.8323329.1026.1517875165.965008.png,0.0,0.0,797,891
1.2.276.0.7230010.3.1.4.8323329.1027.1517875165.972191.png,413770,{},1,0,"{""name"":""rect"",""x"":134,""y"":52,""width"":805,""height"":938}",{},938,rect,805,134,52,/home/dianwen/SIIM_ACR/train/images/1024/dicom/1.2.276.0.7230010.3.1.4.8323329.1027.1517875165.972191.png,/home/dianwen/SIIM_ACR/train/images/1024/mask/1.2.276.0.7230010.3.1.4.8323329.1027.1517875165.972191.png,0.0,0.0,990,939
1.2.276.0.7230010.3.1.4.8323329.1028.1517875165.971389.png,402895,{},1,0,"{""name"":""rect"",""x"":136,""y"":152,""width"":697,""height"":818}",{},818,rect,697,136,152,/home/dianwen/SIIM_ACR/train/images/1024/dicom/1.2.276.0.7230010.3.1.4.8323329.1028.1517875165.971389.png,/home/dianwen/SIIM_ACR/train/images/1024/mask/1.2.276.0.7230010.3.1.4.8323329.1028.1517875165.971389.png,0.0006055831909179688,1.0,970,833
1.2.276.0.7230010.3.1.4.8323329.1029.1517875165.979559.png,300565,{},1,0,"{""name"":""rect"",""x"":99,""y"":133,""width"":835,""height"":736}",{},736,rect,835,99,133,/home/dianwen/SIIM_ACR/train/images/1024/dicom/1.2.276.0.7230010.3.1.4.8323329.1029.1517875165.979559.png,/home/dianwen/SIIM_ACR/train/images/1024/mask/1.2.276.0.7230010.3.1.4.8323329.1029.1517875165.979559.png,0.0,0.0,869,934
1.2.276.0.7230010.3.1.4.8323329.1030.1517875165.982367.png,429846,{},1,0,"{""name"":""rect"",""x"":145,""y"":51,""width"":775,""height"":795}",{},795,rect,775,145,51,/home/dianwen/SIIM_ACR/train/images/1024/dicom/1.2.276.0.7230010.3.1.4.8323329.1030.1517875165.982367.png,/home/dianwen/SIIM_ACR/train/images/1024/mask/1.2.276.0.7230010.3.1.4.8323329.1030.1517875165.982367.png,0.006659507751464844,1.0,846,920
1.2.276.0.7230010.3.1.4.8323329.1031.1517875165.984834.png,406829,{},1,0,"{""name"":""rect"",""x"":112,""y"":87,""width"":758,""height"":936}",{},936,rect,758,112,87,/home/dianwen/SIIM_ACR/train/images/1024/dicom/1.2.276.0.7230010.3.1.4.8323329.1031.1517875165.984834.png,/home/dianwen/SIIM_ACR/train/images/1024/mask/1.2.276.0.7230010.3.1.4.8323329.1031.1517875165.984834.png,0.0,0.0,1023,870
1.2.276.0.7230010.3.1.4.8323329.1032.1517875165.2886.png,354324,{},1,0,"{""name"":""rect"",""x"":144,""y"":262,""width"":650,""height"":617}",{},617,rect,650,144,262,/home/dianwen/SIIM_ACR/train/images/1024/dicom/1.2.276.0.7230010.3.1.4.8323329.1032.1517875165.2886.png,/home/dianwen/SIIM_ACR/train/images/1024/mask/1.2.276.0.7230010.3.1.4.8323329.1032.1517875165.2886.png,0.0,0.0,879,794
1.2.276.0.7230010.3.1.4.8323329.1033.1517875166.9366.png,359024,{},1,0,"{""name"":""rect"",""x"":245,""y"":152,""width"":767,""height"":859}",{},859,rect,767,245,152,/home/dianwen/SIIM_ACR/train/images/1024/dicom/1.2.276.0.7230010.3.1.4.8323329.1033.1517875166.9366.png,/home/dianwen/SIIM_ACR/train/images/1024/mask/1.2.276.0.7230010.3.1.4.8323329.1033.1517875166.9366.png,0.02109050750732422,1.0,1011,1012
1.2.276.0.7230010.3.1.4.8323329.1034.1517875166.8504.png,399870,{},1,0,"{""name"":""rect"",""x"":221,""y"":170,""width"":743,""height"":666}",{},666,rect,743,221,170,/home/dianwen/SIIM_ACR/train/images/1024/dicom/1.2.276.0.7230010.3.1.4.8323329.1034.1517875166.8504.png,/home/dianwen/SIIM_ACR/train/images/1024/mask/1.2.276.0.7230010.3.1.4.8323329.1034.1517875166.8504.png,0.0,0.0,836,964
1.2.276.0.7230010.3.1.4.8323329.1035.1517875166.4496.png,315430,{},1,0,"{""name"":""rect"",""x"":72,""y"":152,""width"":845,""height"":870}",{},870,rect,845,72,152,/home/dianwen/SIIM_ACR/train/images/1024/dicom/1.2.276.0.7230010.3.1.4.8323329.1035.1517875166.4496.png,/home/dianwen/SIIM_ACR/train/images/1024/mask/1.2.276.0.7230010.3.1.4.8323329.1035.1517875166.4496.png,0.0,0.0,1022,917
1.2.276.0.7230010.3.1.4.8323329.1036.1517875166.13055.png,437572,{},1,0,"{""name"":""rect"",""x"":96,""y"":80,""width"":895,""height"":727}",{},727,rect,895,96,80,/home/dianwen/SIIM_ACR/train/images/1024/dicom/1.2.276.0.7230010.3.1.4.8323329.1036.1517875166.13055.png,/home/dianwen/SIIM_ACR/train/images/1024/mask/1.2.276.0.7230010.3.1.4.8323329.1036.1517875166.13055.png,0.0,0.0,807,991
1.2.276.0.7230010.3.1.4.8323329.1037.1517875166.14849.png,314282,{},1,0,"{""name"":""rect"",""x"":178,""y"":130,""width"":843,""height"":860}",{},860,rect,843,178,130,/home/dianwen/SIIM_ACR/train/images/1024/dicom/1.2.276.0.7230010.3.1.4.8323329.1037.1517875166.14849.png,/home/dianwen/SIIM_ACR/train/images/1024/mask/1.2.276.0.7230010.3.1.4.8323329.1037.1517875166.14849.png,0.0,0.0,990,1021
1.2.276.0.7230010.3.1.4.8323329.1038.1517875166.7134.png,433274,{},1,0,"{""name"":""rect"",""x"":144,""y"":87,""width"":756,""height"":677}",{},677,rect,756,144,87,/home/dianwen/SIIM_ACR/train/images/1024/dicom/1.2.276.0.7230010.3.1.4.8323329.1038.1517875166.7134.png,/home/dianwen/SIIM_ACR/train/images/1024/mask/1.2.276.0.7230010.3.1.4.8323329.1038.1517875166.7134.png,0.0,0.0,764,900
1.2.276.0.7230010.3.1.4.8323329.1039.1517875166.21551.png,412575,{},1,0,"{""name"":""rect"",""x"":86,""y"":77,""width"":836,""height"":777}",{},777,rect,836,86,77,/home/dianwen/SIIM_ACR/train/images/1024/dicom/1.2.276.0.7230010.3.1.4.8323329.1039.1517875166.21551.png,/home/dianwen/SIIM_ACR/train/images/1024/mask/1.2.276.0.7230010.3.1.4.8323329.1039.1517875166.21551.png,0.003170013427734375,1.0,854,922
1.2.276.0.7230010.3.1.4.8323329.1040.1517875166.31087.png,330689,{},1,0,"{""name"":""rect"",""x"":49,""y"":214,""width"":817,""height"":711}",{},711,rect,817,49,214,/home/dianwen/SIIM_ACR/train/images/1024/dicom/1.2.276.0.7230010.3.1.4.8323329.1040.1517875166.31087.png,/home/dianwen/SIIM_ACR/train/images/1024/mask/1.2.276.0.7230010.3.1.4.8323329.1040.1517875166.31087.png,0.0,0.0,925,866
1.2.276.0.7230010.3.1.4.8323329.1041.1517875166.34628.png,444023,{},1,0,"{""name"":""rect"",""x"":66,""y"":21,""width"":928,""height"":927}",{},927,rect,928,66,21,/home/dianwen/SIIM_ACR/train/images/1024/dicom/1.2.276.0.7230010.3.1.4.8323329.1041.1517875166.34628.png,/home/dianwen/SIIM_ACR/train/images/1024/mask/1.2.276.0.7230010.3.1.4.8323329.1041.1517875166.34628.png,0.0,0.0,948,994
1.2.276.0.7230010.3.1.4.8323329.1042.1517875166.39303.png,349242,{},1,0,"{""name"":""rect"",""x"":78,""y"":76,""width"":807,""height"":819}",{},819,rect,807,78,76,/home/dianwen/SIIM_ACR/train/images/1024/dicom/1.2.276.0.7230010.3.1.4.8323329.1042.1517875166.39303.png,/home/dianwen/SIIM_ACR/train/images/1024/mask/1.2.276.0.7230010.3.1.4.8323329.1042.1517875166.39303.png,0.010107040405273438,1.0,895,885
1.2.276.0.7230010.3.1.4.8323329.1045.1517875166.42113.png,363242,{},1,0,"{""name"":""rect"",""x"":145,""y"":97,""width"":830,""height"":912}",{},912,rect,830,145,97,/home/dianwen/SIIM_ACR/train/images/1024/dicom/1.2.276.0.7230010.3.1.4.8323329.1045.1517875166.42113.png,/home/dianwen/SIIM_ACR/train/images/1024/mask/1.2.276.0.7230010.3.1.4.8323329.1045.1517875166.42113.png,0.0,0.0,1009,975
1.2.276.0.7230010.3.1.4.8323329.1046.1517875166.44372.png,415875,{},1,0,"{""name"":""rect"",""x"":87,""y"":78,""width"":822,""height"":753}",{},753,rect,822,87,78,/home/dianwen/SIIM_ACR/train/images/1024/dicom/1.2.276.0.7230010.3.1.4.8323329.1046.1517875166.44372.png,/home/dianwen/SIIM_ACR/train/images/1024/mask/1.2.276.0.7230010.3.1.4.8323329.1046.1517875166.44372.png,0.0,0.0,831,909
1.2.276.0.7230010.3.1.4.8323329.1047.1517875166.51539.png,354428,{},1,0,"{""name"":""rect"",""x"":67,""y"":35,""width"":835,""height"":907}",{},907,rect,835,67,35,/home/dianwen/SIIM_ACR/train/images/1024/dicom/1.2.276.0.7230010.3.1.4.8323329.1047.1517875166.51539.png,/home/dianwen/SIIM_ACR/train/images/1024/mask/1.2.276.0.7230010.3.1.4.8323329.1047.1517875166.51539.png,0.0,0.0,942,902
1.2.276.0.7230010.3.1.4.8323329.1048.1517875166.56276.png,452478,{},1,0,"{""name"":""rect"",""x"":1,""y"":94,""width"":959,""height"":869}",{},869,rect,959,1,94,/home/dianwen/SIIM_ACR/train/images/1024/dicom/1.2.276.0.7230010.3.1.4.8323329.1048.1517875166.56276.png,/home/dianwen/SIIM_ACR/train/images/1024/mask/1.2.276.0.7230010.3.1.4.8323329.1048.1517875166.56276.png,0.0,0.0,963,960
1.2.276.0.7230010.3.1.4.8323329.1049.1517875166.66031.png,430371,{},1,0,"{""name"":""rect"",""x"":96,""y"":63,""width"":898,""height"":791}",{},791,rect,898,96,63,/home/dianwen/SIIM_ACR/train/images/1024/dicom/1.2.276.0.7230010.3.1.4.8323329.1049.1517875166.66031.png,/home/dianwen/SIIM_ACR/train/images/1024/mask/1.2.276.0.7230010.3.1.4.8323329.1049.1517875166.66031.png,0.0,0.0,854,994
1.2.276.0.7230010.3.1.4.8323329.1050.1517875166.61982.png,291605,{},1,0,"{""name"":""rect"",""x"":288,""y"":93,""width"":716,""height"":778}",{},778,rect,716,288,93,/home/dianwen/SIIM_ACR/train/images/1024/dicom/1.2.276.0.7230010.3.1.4.8323329.1050.1517875166.61982.png,/home/dianwen/SIIM_ACR/train/images/1024/mask/1.2.276.0.7230010.3.1.4.8323329.1050.1517875166.61982.png,0.0,0.0,871,1004
1.2.276.0.7230010.3.1.4.8323329.1051.1517875166.74991.png,418257,{},1,0,"{""name"":""rect"",""x"":91,""y"":105,""width"":871,""height"":800}",{},800,rect,871,91,105,/home/dianwen/SIIM_ACR/train/images/1024/dicom/1.2.276.0.7230010.3.1.4.8323329.1051.1517875166.74991.png,/home/dianwen/SIIM_ACR/train/images/1024/mask/1.2.276.0.7230010.3.1.4.8323329.1051.1517875166.74991.png,0.028656959533691406,1.0,905,962
1.2.276.0.7230010.3.1.4.8323329.1052.1517875166.81072.png,410682,{},1,0,"{""name"":""rect"",""x"":152,""y"":83,""width"":824,""height"":799}",{},799,rect,824,152,83,/home/dianwen/SIIM_ACR/train/images/1024/dicom/1.2.276.0.7230010.3.1.4.8323329.1052.1517875166.81072.png,/home/dianwen/SIIM_ACR/train/images/1024/mask/1.2.276.0.7230010.3.1.4.8323329.1052.1517875166.81072.png,0.0,0.0,882,976
1.2.276.0.7230010.3.1.4.8323329.1053.1517875166.78060.png,410437,{},1,0,"{""name"":""rect"",""x"":133,""y"":96,""width"":731,""height"":665}",{},665,rect,731,133,96,/home/dianwen/SIIM_ACR/train/images/1024/dicom/1.2.276.0.7230010.3.1.4.8323329.1053.1517875166.78060.png,/home/dianwen/SIIM_ACR/train/images/1024/mask/1.2.276.0.7230010.3.1.4.8323329.1053.1517875166.78060.png,0.0,0.0,761,864
1.2.276.0.7230010.3.1.4.8323329.1054.1517875166.79791.png,377606,{},1,0,"{""name"":""rect"",""x"":141,""y"":121,""width"":649,""height"":527}",{},527,rect,649,141,121,/home/dianwen/SIIM_ACR/train/images/1024/dicom/1.2.276.0.7230010.3.1.4.8323329.1054.1517875166.79791.png,/home/dianwen/SIIM_ACR/train/images/1024/mask/1.2.276.0.7230010.3.1.4.8323329.1054.1517875166.79791.png,0.0,0.0,648,790
1.2.276.0.7230010.3.1.4.8323329.1055.1517875166.90196.png,327451,{},1,0,"{""name"":""rect"",""x"":160,""y"":94,""width"":752,""height"":882}",{},882,rect,752,160,94,/home/dianwen/SIIM_ACR/train/images/1024/dicom/1.2.276.0.7230010.3.1.4.8323329.1055.1517875166.90196.png,/home/dianwen/SIIM_ACR/train/images/1024/mask/1.2.276.0.7230010.3.1.4.8323329.1055.1517875166.90196.png,0.0,0.0,976,912
1.2.276.0.7230010.3.1.4.8323329.1056.1517875166.87722.png,358112,{},1,0,"{""name"":""rect"",""x"":84,""y"":82,""width"":811,""height"":715}",{},715,rect,811,84,82,/home/dianwen/SIIM_ACR/train/images/1024/dicom/1.2.276.0.7230010.3.1.4.8323329.1056.1517875166.87722.png,/home/dianwen/SIIM_ACR/train/images/1024/mask/1.2.276.0.7230010.3.1.4.8323329.1056.1517875166.87722.png,0.0,0.0,797,895
1.2.276.0.7230010.3.1.4.8323329.1057.1517875166.87692.png,419707,{},1,0,"{""name"":""rect"",""x"":146,""y"":60,""width"":669,""height"":754}",{},754,rect,669,146,60,/home/dianwen/SIIM_ACR/train/images/1024/dicom/1.2.276.0.7230010.3.1.4.8323329.1057.1517875166.87692.png,/home/dianwen/SIIM_ACR/train/images/1024/mask/1.2.276.0.7230010.3.1.4.8323329.1057.1517875166.87692.png,0.004679679870605469,1.0,814,815
1.2.276.0.7230010.3.1.4.8323329.1058.1517875166.100769.png,357552,{},1,0,"{""name"":""rect"",""x"":222,""y"":240,""width"":739,""height"":716}",{},716,rect,739,222,240,/home/dianwen/SIIM_ACR/train/images/1024/dicom/1.2.276.0.7230010.3.1.4.8323329.1058.1517875166.100769.png,/home/dianwen/SIIM_ACR/train/images/1024/mask/1.2.276.0.7230010.3.1.4.8323329.1058.1517875166.100769.png,0.0,0.0,956,961
1.2.276.0.7230010.3.1.4.8323329.1059.1517875166.100046.png,329776,{},1,0,"{""name"":""rect"",""x"":99,""y"":253,""width"":729,""height"":655}",{},655,rect,729,99,253,/home/dianwen/SIIM_ACR/train/images/1024/dicom/1.2.276.0.7230010.3.1.4.8323329.1059.1517875166.100046.png,/home/dianwen/SIIM_ACR/train/images/1024/mask/1.2.276.0.7230010.3.1.4.8323329.1059.1517875166.100046.png,0.0,0.0,908,828
1.2.276.0.7230010.3.1.4.8323329.1060.1517875166.102302.png,449855,{},1,0,"{""name"":""rect"",""x"":27,""y"":59,""width"":907,""height"":791}",{},791,rect,907,27,59,/home/dianwen/SIIM_ACR/train/images/1024/dicom/1.2.276.0.7230010.3.1.4.8323329.1060.1517875166.102302.png,/home/dianwen/SIIM_ACR/train/images/1024/mask/1.2.276.0.7230010.3.1.4.8323329.1060.1517875166.102302.png,0.0,0.0,850,934
1.2.276.0.7230010.3.1.4.8323329.1061.1517875166.104673.png,277339,{},1,0,"{""name"":""rect"",""x"":112,""y"":174,""width"":736,""height"":641}",{},641,rect,736,112,174,/home/dianwen/SIIM_ACR/train/images/1024/dicom/1.2.276.0.7230010.3.1.4.8323329.1061.1517875166.104673.png,/home/dianwen/SIIM_ACR/train/images/1024/mask/1.2.276.0.7230010.3.1.4.8323329.1061.1517875166.104673.png,0.0,0.0,815,848
1.2.276.0.7230010.3.1.4.8323329.1062.1517875166.111264.png,430383,{},1,0,"{""name"":""rect"",""x"":110,""y"":122,""width"":851,""height"":897}",{},897,rect,851,110,122,/home/dianwen/SIIM_ACR/train/images/1024/dicom/1.2.276.0.7230010.3.1.4.8323329.1062.1517875166.111264.png,/home/dianwen/SIIM_ACR/train/images/1024/mask/1.2.276.0.7230010.3.1.4.8323329.1062.1517875166.111264.png,0.0,0.0,1019,961
1.2.276.0.7230010.3.1.4.8323329.1063.1517875166.112494.png,385096,{},1,0,"{""name"":""rect"",""x"":191,""y"":117,""width"":735,""height"":673}",{},673,rect,735,191,117,/home/dianwen/SIIM_ACR/train/images/1024/dicom/1.2.276.0.7230010.3.1.4.8323329.1063.1517875166.112494.png,/home/dianwen/SIIM_ACR/train/images/1024/mask/1.2.276.0.7230010.3.1.4.8323329.1063.1517875166.112494.png,0.0,0.0,790,926
1.2.276.0.7230010.3.1.4.8323329.1064.1517875166.120137.png,448793,{},1,0,"{""name"":""rect"",""x"":131,""y"":56,""width"":809,""height"":712}",{},712,rect,809,131,56,/home/dianwen/SIIM_ACR/train/images/1024/dicom/1.2.276.0.7230010.3.1.4.8323329.1064.1517875166.120137.png,/home/dianwen/SIIM_ACR/train/images/1024/mask/1.2.276.0.7230010.3.1.4.8323329.1064.1517875166.120137.png,0.0,0.0,768,940
1.2.276.0.7230010.3.1.4.8323329.1065.1517875166.126456.png,377921,{},1,0,"{""name"":""rect"",""x"":171,""y"":130,""width"":639,""height"":793}",{},793,rect,639,171,130,/home/dianwen/SIIM_ACR/train/images/1024/dicom/1.2.276.0.7230010.3.1.4.8323329.1065.1517875166.126456.png,/home/dianwen/SIIM_ACR/train/images/1024/mask/1.2.276.0.7230010.3.1.4.8323329.1065.1517875166.126456.png,0.0,0.0,923,810
1.2.276.0.7230010.3.1.4.8323329.1066.1517875166.134239.png,362464,{},1,0,"{""name"":""rect"",""x"":39,""y"":176,""width"":965,""height"":845}",{},845,rect,965,39,176,/home/dianwen/SIIM_ACR/train/images/1024/dicom/1.2.276.0.7230010.3.1.4.8323329.1066.1517875166.134239.png,/home/dianwen/SIIM_ACR/train/images/1024/mask/1.2.276.0.7230010.3.1.4.8323329.1066.1517875166.134239.png,0.0,0.0,1021,1004
1.2.276.0.7230010.3.1.4.8323329.1067.1517875166.143971.png,440859,{},1,0,"{""name"":""rect"",""x"":108,""y"":204,""width"":793,""height"":795}",{},795,rect,793,108,204,/home/dianwen/SIIM_ACR/train/images/1024/dicom/1.2.276.0.7230010.3.1.4.8323329.1067.1517875166.143971.png,/home/dianwen/SIIM_ACR/train/images/1024/mask/1.2.276.0.7230010.3.1.4.8323329.1067.1517875166.143971.png,0.004711151123046875,1.0,999,901
1.2.276.0.7230010.3.1.4.8323329.1068.1517875166.144255.png,295462,{},1,0,"{""name"":""rect"",""x"":43,""y"":150,""width"":913,""height"":752}",{},752,rect,913,43,150,/home/dianwen/SIIM_ACR/train/images/1024/dicom/1.2.276.0.7230010.3.1.4.8323329.1068.1517875166.144255.png,/home/dianwen/SIIM_ACR/train/images/1024/mask/1.2.276.0.7230010.3.1.4.8323329.1068.1517875166.144255.png,,,902,956
1.2.276.0.7230010.3.1.4.8323329.1069.1517875166.146485.png,417861,{},1,0,"{""name"":""rect"",""x"":120,""y"":122,""width"":874,""height"":825}",{},825,rect,874,120,122,/home/dianwen/SIIM_ACR/train/images/1024/dicom/1.2.276.0.7230010.3.1.4.8323329.1069.1517875166.146485.png,/home/dianwen/SIIM_ACR/train/images/1024/mask/1.2.276.0.7230010.3.1.4.8323329.1069.1517875166.146485.png,0.0,0.0,947,994
1.2.276.0.7230010.3.1.4.8323329.1070.1517875166.153175.png,315964,{},1,0,"{""name"":""rect"",""x"":156,""y"":224,""width"":774,""height"":797}",{},797,rect,774,156,224,/home/dianwen/SIIM_ACR/train/images/1024/dicom/1.2.276.0.7230010.3.1.4.8323329.1070.1517875166.153175.png,/home/dianwen/SIIM_ACR/train/images/1024/mask/1.2.276.0.7230010.3.1.4.8323329.1070.1517875166.153175.png,0.0,0.0,1021,930
1.2.276.0.7230010.3.1.4.8323329.1071.1517875166.156682.png,372720,{},1,0,"{""name"":""rect"",""x"":137,""y"":92,""width"":726,""height"":821}",{},821,rect,726,137,92,/home/dianwen/SIIM_ACR/train/images/1024/dicom/1.2.276.0.7230010.3.1.4.8323329.1071.1517875166.156682.png,/home/dianwen/SIIM_ACR/train/images/1024/mask/1.2.276.0.7230010.3.1.4.8323329.1071.1517875166.156682.png,0.0,0.0,913,863
1.2.276.0.7230010.3.1.4.8323329.1072.1517875166.176122.png,336380,{},1,0,"{""name"":""rect"",""x"":97,""y"":61,""width"":782,""height"":829}",{},829,rect,782,97,61,/home/dianwen/SIIM_ACR/train/images/1024/dicom/1.2.276.0.7230010.3.1.4.8323329.1072.1517875166.176122.png,/home/dianwen/SIIM_ACR/train/images/1024/mask/1.2.276.0.7230010.3.1.4.8323329.1072.1517875166.176122.png,0.0,0.0,890,879
1.2.276.0.7230010.3.1.4.8323329.1073.1517875166.186056.png,330629,{},1,0,"{""name"":""rect"",""x"":161,""y"":146,""width"":732,""height"":638}",{},638,rect,732,161,146,/home/dianwen/SIIM_ACR/train/images/1024/dicom/1.2.276.0.7230010.3.1.4.8323329.1073.1517875166.186056.png,/home/dianwen/SIIM_ACR/train/images/1024/mask/1.2.276.0.7230010.3.1.4.8323329.1073.1517875166.186056.png,0.0,0.0,784,893
1.2.276.0.7230010.3.1.4.8323329.1074.1517875166.199707.png,305933,{},1,0,"{""name"":""rect"",""x"":103,""y"":45,""width"":735,""height"":864}",{},864,rect,735,103,45,/home/dianwen/SIIM_ACR/train/images/1024/dicom/1.2.276.0.7230010.3.1.4.8323329.1074.1517875166.199707.png,/home/dianwen/SIIM_ACR/train/images/1024/mask/1.2.276.0.7230010.3.1.4.8323329.1074.1517875166.199707.png,0.0,0.0,909,838
1.2.276.0.7230010.3.1.4.8323329.1075.1517875166.202853.png,437507,{},1,0,"{""name"":""rect"",""x"":138,""y"":31,""width"":748,""height"":965}",{},965,rect,748,138,31,/home/dianwen/SIIM_ACR/train/images/1024/dicom/1.2.276.0.7230010.3.1.4.8323329.1075.1517875166.202853.png,/home/dianwen/SIIM_ACR/train/images/1024/mask/1.2.276.0.7230010.3.1.4.8323329.1075.1517875166.202853.png,0.0,0.0,996,886
1.2.276.0.7230010.3.1.4.8323329.1076.1517875166.212353.png,348012,{},1,0,"{""name"":""rect"",""x"":69,""y"":91,""width"":886,""height"":807}",{},807,rect,886,69,91,/home/dianwen/SIIM_ACR/train/images/1024/dicom/1.2.276.0.7230010.3.1.4.8323329.1076.1517875166.212353.png,/home/dianwen/SIIM_ACR/train/images/1024/mask/1.2.276.0.7230010.3.1.4.8323329.1076.1517875166.212353.png,0.0,0.0,898,955
1.2.276.0.7230010.3.1.4.8323329.1077.1517875166.213062.png,428366,{},1,0,"{""name"":""rect"",""x"":47,""y"":58,""width"":819,""height"":690}",{},690,rect,819,47,58,/home/dianwen/SIIM_ACR/train/images/1024/dicom/1.2.276.0.7230010.3.1.4.8323329.1077.1517875166.213062.png,/home/dianwen/SIIM_ACR/train/images/1024/mask/1.2.276.0.7230010.3.1.4.8323329.1077.1517875166.213062.png,0.004393577575683594,1.0,748,866
1.2.276.0.7230010.3.1.4.8323329.1078.1517875166.227967.png,416740,{},1,0,"{""name"":""rect"",""x"":47,""y"":117,""width"":872,""height"":852}",{},852,rect,872,47,117,/home/dianwen/SIIM_ACR/train/images/1024/dicom/1.2.276.0.7230010.3.1.4.8323329.1078.1517875166.227967.png,/home/dianwen/SIIM_ACR/train/images/1024/mask/1.2.276.0.7230010.3.1.4.8323329.1078.1517875166.227967.png,0.0,0.0,969,919
1.2.276.0.7230010.3.1.4.8323329.1079.1517875166.224401.png,363334,{},1,0,"{""name"":""rect"",""x"":82,""y"":58,""width"":935,""height"":776}",{},776,rect,935,82,58,/home/dianwen/SIIM_ACR/train/images/1024/dicom/1.2.276.0.7230010.3.1.4.8323329.1079.1517875166.224401.png,/home/dianwen/SIIM_ACR/train/images/1024/mask/1.2.276.0.7230010.3.1.4.8323329.1079.1517875166.224401.png,0.0,0.0,834,1017
1.2.276.0.7230010.3.1.4.8323329.1080.1517875166.235178.png,415797,{},1,0,"{""name"":""rect"",""x"":72,""y"":88,""width"":804,""height"":808}",{},808,rect,804,72,88,/home/dianwen/SIIM_ACR/train/images/1024/dicom/1.2.276.0.7230010.3.1.4.8323329.1080.1517875166.235178.png,/home/dianwen/SIIM_ACR/train/images/1024/mask/1.2.276.0.7230010.3.1.4.8323329.1080.1517875166.235178.png,0.004334449768066406,1.0,896,876
1.2.276.0.7230010.3.1.4.8323329.1081.1517875166.228103.png,345025,{},1,0,"{""name"":""rect"",""x"":135,""y"":52,""width"":707,""height"":891}",{},891,rect,707,135,52,/home/dianwen/SIIM_ACR/train/images/1024/dicom/1.2.276.0.7230010.3.1.4.8323329.1081.1517875166.228103.png,/home/dianwen/SIIM_ACR/train/images/1024/mask/1.2.276.0.7230010.3.1.4.8323329.1081.1517875166.228103.png,0.0,0.0,943,842
1.2.276.0.7230010.3.1.4.8323329.1082.1517875166.234899.png,384107,{},1,0,"{""name"":""rect"",""x"":109,""y"":94,""width"":811,""height"":864}",{},864,rect,811,109,94,/home/dianwen/SIIM_ACR/train/images/1024/dicom/1.2.276.0.7230010.3.1.4.8323329.1082.1517875166.234899.png,/home/dianwen/SIIM_ACR/train/images/1024/mask/1.2.276.0.7230010.3.1.4.8323329.1082.1517875166.234899.png,0.0,0.0,958,920
1.2.276.0.7230010.3.1.4.8323329.1083.1517875166.251531.png,392484,{},1,0,"{""name"":""rect"",""x"":160,""y"":117,""width"":699,""height"":814}",{},814,rect,699,160,117,/home/dianwen/SIIM_ACR/train/images/1024/dicom/1.2.276.0.7230010.3.1.4.8323329.1083.1517875166.251531.png,/home/dianwen/SIIM_ACR/train/images/1024/mask/1.2.276.0.7230010.3.1.4.8323329.1083.1517875166.251531.png,0.0003719329833984375,1.0,931,859
1.2.276.0.7230010.3.1.4.8323329.1084.1517875166.254101.png,339779,{},1,0,"{""name"":""rect"",""x"":151,""y"":77,""width"":696,""height"":936}",{},936,rect,696,151,77,/home/dianwen/SIIM_ACR/train/images/1024/dicom/1.2.276.0.7230010.3.1.4.8323329.1084.1517875166.254101.png,/home/dianwen/SIIM_ACR/train/images/1024/mask/1.2.276.0.7230010.3.1.4.8323329.1084.1517875166.254101.png,0.022653579711914062,1.0,1013,847
1.2.276.0.7230010.3.1.4.8323329.1085.1517875166.265258.png,287826,{},1,0,"{""name"":""rect"",""x"":165,""y"":86,""width"":839,""height"":936}",{},936,rect,839,165,86,/home/dianwen/SIIM_ACR/train/images/1024/dicom/1.2.276.0.7230010.3.1.4.8323329.1085.1517875166.265258.png,/home/dianwen/SIIM_ACR/train/images/1024/mask/1.2.276.0.7230010.3.1.4.8323329.1085.1517875166.265258.png,0.0,0.0,1022,1004
1.2.276.0.7230010.3.1.4.8323329.1086.1517875166.262172.png,370902,{},1,0,"{""name"":""rect"",""x"":144,""y"":111,""width"":696,""height"":753}",{},753,rect,696,144,111,/home/dianwen/SIIM_ACR/train/images/1024/dicom/1.2.276.0.7230010.3.1.4.8323329.1086.1517875166.262172.png,/home/dianwen/SIIM_ACR/train/images/1024/mask/1.2.276.0.7230010.3.1.4.8323329.1086.1517875166.262172.png,0.0,0.0,864,840
1.2.276.0.7230010.3.1.4.8323329.1087.1517875166.274989.png,433106,{},1,0,"{""name"":""rect"",""x"":173,""y"":52,""width"":792,""height"":884}",{},884,rect,792,173,52,/home/dianwen/SIIM_ACR/train/images/1024/dicom/1.2.276.0.7230010.3.1.4.8323329.1087.1517875166.274989.png,/home/dianwen/SIIM_ACR/train/images/1024/mask/1.2.276.0.7230010.3.1.4.8323329.1087.1517875166.274989.png,0.010020256042480469,1.0,936,965
1.2.276.0.7230010.3.1.4.8323329.1088.1517875166.276460.png,420642,{},1,0,"{""name"":""rect"",""x"":111,""y"":109,""width"":743,""height"":873}",{},873,rect,743,111,109,/home/dianwen/SIIM_ACR/train/images/1024/dicom/1.2.276.0.7230010.3.1.4.8323329.1088.1517875166.276460.png,/home/dianwen/SIIM_ACR/train/images/1024/mask/1.2.276.0.7230010.3.1.4.8323329.1088.1517875166.276460.png,0.0,0.0,982,854
1.2.276.0.7230010.3.1.4.8323329.1089.1517875166.272851.png,396201,{},1,0,"{""name"":""rect"",""x"":197,""y"":120,""width"":668,""height"":739}",{},739,rect,668,197,120,/home/dianwen/SIIM_ACR/train/images/1024/dicom/1.2.276.0.7230010.3.1.4.8323329.1089.1517875166.272851.png,/home/dianwen/SIIM_ACR/train/images/1024/mask/1.2.276.0.7230010.3.1.4.8323329.1089.1517875166.272851.png,0.0,0.0,859,865
1.2.276.0.7230010.3.1.4.8323329.1090.1517875166.281504.png,404472,{},1,0,"{""name"":""rect"",""x"":129,""y"":270,""width"":660,""height"":752}",{},752,rect,660,129,270,/home/dianwen/SIIM_ACR/train/images/1024/dicom/1.2.276.0.7230010.3.1.4.8323329.1090.1517875166.281504.png,/home/dianwen/SIIM_ACR/train/images/1024/mask/1.2.276.0.7230010.3.1.4.8323329.1090.1517875166.281504.png,0.025577545166015625,1.0,1022,789
1.2.276.0.7230010.3.1.4.8323329.1091.1517875166.285986.png,340366,{},1,0,"{""name"":""rect"",""x"":193,""y"":60,""width"":683,""height"":841}",{},841,rect,683,193,60,/home/dianwen/SIIM_ACR/train/images/1024/dicom/1.2.276.0.7230010.3.1.4.8323329.1091.1517875166.285986.png,/home/dianwen/SIIM_ACR/train/images/1024/mask/1.2.276.0.7230010.3.1.4.8323329.1091.1517875166.285986.png,0.016928672790527344,1.0,901,876
1.2.276.0.7230010.3.1.4.8323329.1092.1517875166.290633.png,421351,{},1,0,"{""name"":""rect"",""x"":138,""y"":186,""width"":861,""height"":794}",{},794,rect,861,138,186,/home/dianwen/SIIM_ACR/train/images/1024/dicom/1.2.276.0.7230010.3.1.4.8323329.1092.1517875166.290633.png,/home/dianwen/SIIM_ACR/train/images/1024/mask/1.2.276.0.7230010.3.1.4.8323329.1092.1517875166.290633.png,0.002533912658691407,1.0,980,999
1.2.276.0.7230010.3.1.4.8323329.1093.1517875166.300291.png,351384,{},1,0,"{""name"":""rect"",""x"":53,""y"":53,""width"":868,""height"":945}",{},945,rect,868,53,53,/home/dianwen/SIIM_ACR/train/images/1024/dicom/1.2.276.0.7230010.3.1.4.8323329.1093.1517875166.300291.png,/home/dianwen/SIIM_ACR/train/images/1024/mask/1.2.276.0.7230010.3.1.4.8323329.1093.1517875166.300291.png,0.0,0.0,998,921
1.2.276.0.7230010.3.1.4.8323329.1094.1517875166.307829.png,320074,{},1,0,"{""name"":""rect"",""x"":128,""y"":128,""width"":752,""height"":833}",{},833,rect,752,128,128,/home/dianwen/SIIM_ACR/train/images/1024/dicom/1.2.276.0.7230010.3.1.4.8323329.1094.1517875166.307829.png,/home/dianwen/SIIM_ACR/train/images/1024/mask/1.2.276.0.7230010.3.1.4.8323329.1094.1517875166.307829.png,0.0,0.0,961,880
1.2.276.0.7230010.3.1.4.8323329.1095.1517875166.305966.png,442166,{},1,0,"{""name"":""rect"",""x"":81,""y"":58,""width"":797,""height"":910}",{},910,rect,797,81,58,/home/dianwen/SIIM_ACR/train/images/1024/dicom/1.2.276.0.7230010.3.1.4.8323329.1095.1517875166.305966.png,/home/dianwen/SIIM_ACR/train/images/1024/mask/1.2.276.0.7230010.3.1.4.8323329.1095.1517875166.305966.png,0.0,0.0,968,878
1.2.276.0.7230010.3.1.4.8323329.1096.1517875166.315559.png,360120,{},1,0,"{""name"":""rect"",""x"":77,""y"":64,""width"":869,""height"":956}",{},956,rect,869,77,64,/home/dianwen/SIIM_ACR/train/images/1024/dicom/1.2.276.0.7230010.3.1.4.8323329.1096.1517875166.315559.png,/home/dianwen/SIIM_ACR/train/images/1024/mask/1.2.276.0.7230010.3.1.4.8323329.1096.1517875166.315559.png,0.0,0.0,1020,946
1.2.276.0.7230010.3.1.4.8323329.1097.1517875166.317794.png,424885,{},1,0,"{""name"":""rect"",""x"":99,""y"":34,""width"":859,""height"":827}",{},827,rect,859,99,34,/home/dianwen/SIIM_ACR/train/images/1024/dicom/1.2.276.0.7230010.3.1.4.8323329.1097.1517875166.317794.png,/home/dianwen/SIIM_ACR/train/images/1024/mask/1.2.276.0.7230010.3.1.4.8323329.1097.1517875166.317794.png,0.0,0.0,861,958
1.2.276.0.7230010.3.1.4.8323329.1098.1517875166.324879.png,398908,{},1,0,"{""name"":""rect"",""x"":79,""y"":176,""width"":893,""height"":802}",{},802,rect,893,79,176,/home/dianwen/SIIM_ACR/train/images/1024/dicom/1.2.276.0.7230010.3.1.4.8323329.1098.1517875166.324879.png,/home/dianwen/SIIM_ACR/train/images/1024/mask/1.2.276.0.7230010.3.1.4.8323329.1098.1517875166.324879.png,0.0,0.0,978,972
1.2.276.0.7230010.3.1.4.8323329.1099.1517875166.314896.png,388953,{},1,0,"{""name"":""rect"",""x"":40,""y"":104,""width"":905,""height"":723}",{},723,rect,905,40,104,/home/dianwen/SIIM_ACR/train/images/1024/dicom/1.2.276.0.7230010.3.1.4.8323329.1099.1517875166.314896.png,/home/dianwen/SIIM_ACR/train/images/1024/mask/1.2.276.0.7230010.3.1.4.8323329.1099.1517875166.314896.png,0.0,0.0,827,945
1.2.276.0.7230010.3.1.4.8323329.1100.1517875166.335042.png,415193,{},1,0,"{""name"":""rect"",""x"":36,""y"":148,""width"":898,""height"":807}",{},807,rect,898,36,148,/home/dianwen/SIIM_ACR/train/images/1024/dicom/1.2.276.0.7230010.3.1.4.8323329.1100.1517875166.335042.png,/home/dianwen/SIIM_ACR/train/images/1024/mask/1.2.276.0.7230010.3.1.4.8323329.1100.1517875166.335042.png,0.0,0.0,955,934
1.2.276.0.7230010.3.1.4.8323329.1101.1517875166.328177.png,414356,{},1,0,"{""name"":""rect"",""x"":143,""y"":66,""width"":707,""height"":722}",{},722,rect,707,143,66,/home/dianwen/SIIM_ACR/train/images/1024/dicom/1.2.276.0.7230010.3.1.4.8323329.1101.1517875166.328177.png,/home/dianwen/SIIM_ACR/train/images/1024/mask/1.2.276.0.7230010.3.1.4.8323329.1101.1517875166.328177.png,0.0,0.0,788,850
1.2.276.0.7230010.3.1.4.8323329.1102.1517875166.319422.png,433496,{},1,0,"{""name"":""rect"",""x"":127,""y"":59,""width"":763,""height"":759}",{},759,rect,763,127,59,/home/dianwen/SIIM_ACR/train/images/1024/dicom/1.2.276.0.7230010.3.1.4.8323329.1102.1517875166.319422.png,/home/dianwen/SIIM_ACR/train/images/1024/mask/1.2.276.0.7230010.3.1.4.8323329.1102.1517875166.319422.png,0.004632949829101562,1.0,818,890
1.2.276.0.7230010.3.1.4.8323329.1103.1517875166.333033.png,419897,{},1,0,"{""name"":""rect"",""x"":20,""y"":49,""width"":916,""height"":918}",{},918,rect,916,20,49,/home/dianwen/SIIM_ACR/train/images/1024/dicom/1.2.276.0.7230010.3.1.4.8323329.1103.1517875166.333033.png,/home/dianwen/SIIM_ACR/train/images/1024/mask/1.2.276.0.7230010.3.1.4.8323329.1103.1517875166.333033.png,0.0,0.0,967,936
1.2.276.0.7230010.3.1.4.8323329.1104.1517875166.340777.png,403617,{},1,0,"{""name"":""rect"",""x"":127,""y"":34,""width"":827,""height"":956}",{},956,rect,827,127,34,/home/dianwen/SIIM_ACR/train/images/1024/dicom/1.2.276.0.7230010.3.1.4.8323329.1104.1517875166.340777.png,/home/dianwen/SIIM_ACR/train/images/1024/mask/1.2.276.0.7230010.3.1.4.8323329.1104.1517875166.340777.png,0.0,0.0,990,954
1.2.276.0.7230010.3.1.4.8323329.1105.1517875166.337929.png,432677,{},1,0,"{""name"":""rect"",""x"":82,""y"":98,""width"":816,""height"":719}",{},719,rect,816,82,98,/home/dianwen/SIIM_ACR/train/images/1024/dicom/1.2.276.0.7230010.3.1.4.8323329.1105.1517875166.337929.png,/home/dianwen/SIIM_ACR/train/images/1024/mask/1.2.276.0.7230010.3.1.4.8323329.1105.1517875166.337929.png,0.0,0.0,817,898
1.2.276.0.7230010.3.1.4.8323329.1107.1517875166.353408.png,435944,{},1,0,"{""name"":""rect"",""x"":142,""y"":80,""width"":830,""height"":799}",{},799,rect,830,142,80,/home/dianwen/SIIM_ACR/train/images/1024/dicom/1.2.276.0.7230010.3.1.4.8323329.1107.1517875166.353408.png,/home/dianwen/SIIM_ACR/train/images/1024/mask/1.2.276.0.7230010.3.1.4.8323329.1107.1517875166.353408.png,0.004544258117675781,1.0,879,972
1.2.276.0.7230010.3.1.4.8323329.1108.1517875166.353495.png,376933,{},1,0,"{""name"":""rect"",""x"":146,""y"":92,""width"":790,""height"":830}",{},830,rect,790,146,92,/home/dianwen/SIIM_ACR/train/images/1024/dicom/1.2.276.0.7230010.3.1.4.8323329.1108.1517875166.353495.png,/home/dianwen/SIIM_ACR/train/images/1024/mask/1.2.276.0.7230010.3.1.4.8323329.1108.1517875166.353495.png,0.0,0.0,922,936
1.2.276.0.7230010.3.1.4.8323329.1109.1517875166.350005.png,224026,{},1,0,"{""name"":""rect"",""x"":285,""y"":37,""width"":680,""height"":433}",{},433,rect,680,285,37,/home/dianwen/SIIM_ACR/train/images/1024/dicom/1.2.276.0.7230010.3.1.4.8323329.1109.1517875166.350005.png,/home/dianwen/SIIM_ACR/train/images/1024/mask/1.2.276.0.7230010.3.1.4.8323329.1109.1517875166.350005.png,0.0,0.0,470,965
1.2.276.0.7230010.3.1.4.8323329.1111.1517875166.358101.png,353996,{},1,0,"{""name"":""rect"",""x"":55,""y"":67,""width"":927,""height"":884}",{},884,rect,927,55,67,/home/dianwen/SIIM_ACR/train/images/1024/dicom/1.2.276.0.7230010.3.1.4.8323329.1111.1517875166.358101.png,/home/dianwen/SIIM_ACR/train/images/1024/mask/1.2.276.0.7230010.3.1.4.8323329.1111.1517875166.358101.png,0.0,0.0,951,982
1.2.276.0.7230010.3.1.4.8323329.1112.1517875166.353030.png,417812,{},1,0,"{""name"":""rect"",""x"":63,""y"":75,""width"":893,""height"":939}",{},939,rect,893,63,75,/home/dianwen/SIIM_ACR/train/images/1024/dicom/1.2.276.0.7230010.3.1.4.8323329.1112.1517875166.353030.png,/home/dianwen/SIIM_ACR/train/images/1024/mask/1.2.276.0.7230010.3.1.4.8323329.1112.1517875166.353030.png,0.0,0.0,1014,956
1.2.276.0.7230010.3.1.4.8323329.1113.1517875166.361287.png,435034,{},1,0,"{""name"":""rect"",""x"":58,""y"":61,""width"":867,""height"":902}",{},902,rect,867,58,61,/home/dianwen/SIIM_ACR/train/images/1024/dicom/1.2.276.0.7230010.3.1.4.8323329.1113.1517875166.361287.png,/home/dianwen/SIIM_ACR/train/images/1024/mask/1.2.276.0.7230010.3.1.4.8323329.1113.1517875166.361287.png,0.0,0.0,963,925
1.2.276.0.7230010.3.1.4.8323329.1114.1517875166.370574.png,428010,{},1,0,"{""name"":""rect"",""x"":134,""y"":123,""width"":809,""height"":791}",{},791,rect,809,134,123,/home/dianwen/SIIM_ACR/train/images/1024/dicom/1.2.276.0.7230010.3.1.4.8323329.1114.1517875166.370574.png,/home/dianwen/SIIM_ACR/train/images/1024/mask/1.2.276.0.7230010.3.1.4.8323329.1114.1517875166.370574.png,0.0,0.0,914,943
1.2.276.0.7230010.3.1.4.8323329.1115.1517875166.379018.png,340928,{},1,0,"{""name"":""rect"",""x"":127,""y"":93,""width"":756,""height"":821}",{},821,rect,756,127,93,/home/dianwen/SIIM_ACR/train/images/1024/dicom/1.2.276.0.7230010.3.1.4.8323329.1115.1517875166.379018.png,/home/dianwen/SIIM_ACR/train/images/1024/mask/1.2.276.0.7230010.3.1.4.8323329.1115.1517875166.379018.png,0.0,0.0,914,883
1.2.276.0.7230010.3.1.4.8323329.1116.1517875166.388852.png,403743,{},1,0,"{""name"":""rect"",""x"":166,""y"":88,""width"":720,""height"":835}",{},835,rect,720,166,88,/home/dianwen/SIIM_ACR/train/images/1024/dicom/1.2.276.0.7230010.3.1.4.8323329.1116.1517875166.388852.png,/home/dianwen/SIIM_ACR/train/images/1024/mask/1.2.276.0.7230010.3.1.4.8323329.1116.1517875166.388852.png,0.0,0.0,923,886
1.2.276.0.7230010.3.1.4.8323329.1117.1517875166.378544.png,379634,{},1,0,"{""name"":""rect"",""x"":176,""y"":93,""width"":716,""height"":692}",{},692,rect,716,176,93,/home/dianwen/SIIM_ACR/train/images/1024/dicom/1.2.276.0.7230010.3.1.4.8323329.1117.1517875166.378544.png,/home/dianwen/SIIM_ACR/train/images/1024/mask/1.2.276.0.7230010.3.1.4.8323329.1117.1517875166.378544.png,0.004214286804199219,1.0,785,892
1.2.276.0.7230010.3.1.4.8323329.1120.1517875166.388852.png,391853,{},1,0,"{""name"":""rect"",""x"":153,""y"":149,""width"":696,""height"":698}",{},698,rect,696,153,149,/home/dianwen/SIIM_ACR/train/images/1024/dicom/1.2.276.0.7230010.3.1.4.8323329.1120.1517875166.388852.png,/home/dianwen/SIIM_ACR/train/images/1024/mask/1.2.276.0.7230010.3.1.4.8323329.1120.1517875166.388852.png,0.0,0.0,847,849
1.2.276.0.7230010.3.1.4.8323329.1121.1517875166.376070.png,419950,{},1,0,"{""name"":""rect"",""x"":72,""y"":76,""width"":847,""height"":946}",{},946,rect,847,72,76,/home/dianwen/SIIM_ACR/train/images/1024/dicom/1.2.276.0.7230010.3.1.4.8323329.1121.1517875166.376070.png,/home/dianwen/SIIM_ACR/train/images/1024/mask/1.2.276.0.7230010.3.1.4.8323329.1121.1517875166.376070.png,0.025714874267578125,1.0,1022,919
1.2.276.0.7230010.3.1.4.8323329.1123.1517875166.393683.png,237269,{},1,0,"{""name"":""rect"",""x"":213,""y"":251,""width"":552,""height"":623}",{},623,rect,552,213,251,/home/dianwen/SIIM_ACR/train/images/1024/dicom/1.2.276.0.7230010.3.1.4.8323329.1123.1517875166.393683.png,/home/dianwen/SIIM_ACR/train/images/1024/mask/1.2.276.0.7230010.3.1.4.8323329.1123.1517875166.393683.png,0.0,0.0,874,765
1.2.276.0.7230010.3.1.4.8323329.1124.1517875166.400361.png,417581,{},1,0,"{""name"":""rect"",""x"":91,""y"":140,""width"":831,""height"":688}",{},688,rect,831,91,140,/home/dianwen/SIIM_ACR/train/images/1024/dicom/1.2.276.0.7230010.3.1.4.8323329.1124.1517875166.400361.png,/home/dianwen/SIIM_ACR/train/images/1024/mask/1.2.276.0.7230010.3.1.4.8323329.1124.1517875166.400361.png,0.0,0.0,828,922
1.2.276.0.7230010.3.1.4.8323329.1125.1517875166.402381.png,418758,{},1,0,"{""name"":""rect"",""x"":82,""y"":89,""width"":797,""height"":822}",{},822,rect,797,82,89,/home/dianwen/SIIM_ACR/train/images/1024/dicom/1.2.276.0.7230010.3.1.4.8323329.1125.1517875166.402381.png,/home/dianwen/SIIM_ACR/train/images/1024/mask/1.2.276.0.7230010.3.1.4.8323329.1125.1517875166.402381.png,0.0,0.0,911,879
1.2.276.0.7230010.3.1.4.8323329.1126.1517875166.413592.png,363300,{},1,0,"{""name"":""rect"",""x"":82,""y"":9,""width"":826,""height"":884}",{},884,rect,826,82,9,/home/dianwen/SIIM_ACR/train/images/1024/dicom/1.2.276.0.7230010.3.1.4.8323329.1126.1517875166.413592.png,/home/dianwen/SIIM_ACR/train/images/1024/mask/1.2.276.0.7230010.3.1.4.8323329.1126.1517875166.413592.png,0.0,0.0,893,908
1.2.276.0.7230010.3.1.4.8323329.1127.1517875166.411178.png,422082,{},1,0,"{""name"":""rect"",""x"":106,""y"":77,""width"":847,""height"":803}",{},803,rect,847,106,77,/home/dianwen/SIIM_ACR/train/images/1024/dicom/1.2.276.0.7230010.3.1.4.8323329.1127.1517875166.411178.png,/home/dianwen/SIIM_ACR/train/images/1024/mask/1.2.276.0.7230010.3.1.4.8323329.1127.1517875166.411178.png,0.0,0.0,880,953
1.2.276.0.7230010.3.1.4.8323329.1128.1517875166.405039.png,431106,{},1,0,"{""name"":""rect"",""x"":76,""y"":179,""width"":758,""height"":740}",{},740,rect,758,76,179,/home/dianwen/SIIM_ACR/train/images/1024/dicom/1.2.276.0.7230010.3.1.4.8323329.1128.1517875166.405039.png,/home/dianwen/SIIM_ACR/train/images/1024/mask/1.2.276.0.7230010.3.1.4.8323329.1128.1517875166.405039.png,0.0,0.0,919,834
1.2.276.0.7230010.3.1.4.8323329.1129.1517875166.419577.png,412324,{},1,0,"{""name"":""rect"",""x"":163,""y"":86,""width"":811,""height"":751}",{},751,rect,811,163,86,/home/dianwen/SIIM_ACR/train/images/1024/dicom/1.2.276.0.7230010.3.1.4.8323329.1129.1517875166.419577.png,/home/dianwen/SIIM_ACR/train/images/1024/mask/1.2.276.0.7230010.3.1.4.8323329.1129.1517875166.419577.png,0.005641937255859375,1.0,837,974
1.2.276.0.7230010.3.1.4.8323329.1130.1517875166.422767.png,397310,{},1,0,"{""name"":""rect"",""x"":174,""y"":169,""width"":735,""height"":707}",{},707,rect,735,174,169,/home/dianwen/SIIM_ACR/train/images/1024/dicom/1.2.276.0.7230010.3.1.4.8323329.1130.1517875166.422767.png,/home/dianwen/SIIM_ACR/train/images/1024/mask/1.2.276.0.7230010.3.1.4.8323329.1130.1517875166.422767.png,0.0,0.0,876,909
1.2.276.0.7230010.3.1.4.8323329.1131.1517875166.419270.png,354801,{},1,0,"{""name"":""rect"",""x"":123,""y"":23,""width"":854,""height"":976}",{},976,rect,854,123,23,/home/dianwen/SIIM_ACR/train/images/1024/dicom/1.2.276.0.7230010.3.1.4.8323329.1131.1517875166.419270.png,/home/dianwen/SIIM_ACR/train/images/1024/mask/1.2.276.0.7230010.3.1.4.8323329.1131.1517875166.419270.png,0.0,0.0,999,977
1.2.276.0.7230010.3.1.4.8323329.1132.1517875166.422349.png,383914,{},1,0,"{""name"":""rect"",""x"":139,""y"":50,""width"":835,""height"":906}",{},906,rect,835,139,50,/home/dianwen/SIIM_ACR/train/images/1024/dicom/1.2.276.0.7230010.3.1.4.8323329.1132.1517875166.422349.png,/home/dianwen/SIIM_ACR/train/images/1024/mask/1.2.276.0.7230010.3.1.4.8323329.1132.1517875166.422349.png,0.0,0.0,956,974
1.2.276.0.7230010.3.1.4.8323329.1133.1517875166.434041.png,364764,{},1,0,"{""name"":""rect"",""x"":169,""y"":50,""width"":752,""height"":762}",{},762,rect,752,169,50,/home/dianwen/SIIM_ACR/train/images/1024/dicom/1.2.276.0.7230010.3.1.4.8323329.1133.1517875166.434041.png,/home/dianwen/SIIM_ACR/train/images/1024/mask/1.2.276.0.7230010.3.1.4.8323329.1133.1517875166.434041.png,0.0,0.0,812,921
1.2.276.0.7230010.3.1.4.8323329.1134.1517875166.435911.png,365787,{},1,0,"{""name"":""rect"",""x"":222,""y"":77,""width"":598,""height"":696}",{},696,rect,598,222,77,/home/dianwen/SIIM_ACR/train/images/1024/dicom/1.2.276.0.7230010.3.1.4.8323329.1134.1517875166.435911.png,/home/dianwen/SIIM_ACR/train/images/1024/mask/1.2.276.0.7230010.3.1.4.8323329.1134.1517875166.435911.png,0.0,0.0,773,820
1.2.276.0.7230010.3.1.4.8323329.1135.1517875166.429148.png,409957,{},1,0,"{""name"":""rect"",""x"":77,""y"":62,""width"":784,""height"":733}",{},733,rect,784,77,62,/home/dianwen/SIIM_ACR/train/images/1024/dicom/1.2.276.0.7230010.3.1.4.8323329.1135.1517875166.429148.png,/home/dianwen/SIIM_ACR/train/images/1024/mask/1.2.276.0.7230010.3.1.4.8323329.1135.1517875166.429148.png,0.0,0.0,795,861
1.2.276.0.7230010.3.1.4.8323329.1136.1517875166.441388.png,436760,{},1,0,"{""name"":""rect"",""x"":221,""y"":60,""width"":752,""height"":812}",{},812,rect,752,221,60,/home/dianwen/SIIM_ACR/train/images/1024/dicom/1.2.276.0.7230010.3.1.4.8323329.1136.1517875166.441388.png,/home/dianwen/SIIM_ACR/train/images/1024/mask/1.2.276.0.7230010.3.1.4.8323329.1136.1517875166.441388.png,0.00324249267578125,1.0,872,973
1.2.276.0.7230010.3.1.4.8323329.1137.1517875166.441613.png,354928,{},1,0,"{""name"":""rect"",""x"":50,""y"":86,""width"":835,""height"":763}",{},763,rect,835,50,86,/home/dianwen/SIIM_ACR/train/images/1024/dicom/1.2.276.0.7230010.3.1.4.8323329.1137.1517875166.441613.png,/home/dianwen/SIIM_ACR/train/images/1024/mask/1.2.276.0.7230010.3.1.4.8323329.1137.1517875166.441613.png,0.0,0.0,849,885
1.2.276.0.7230010.3.1.4.8323329.1138.1517875166.441012.png,395316,{},1,0,"{""name"":""rect"",""x"":133,""y"":16,""width"":727,""height"":768}",{},768,rect,727,133,16,/home/dianwen/SIIM_ACR/train/images/1024/dicom/1.2.276.0.7230010.3.1.4.8323329.1138.1517875166.441012.png,/home/dianwen/SIIM_ACR/train/images/1024/mask/1.2.276.0.7230010.3.1.4.8323329.1138.1517875166.441012.png,0.025432586669921875,1.0,784,860
1.2.276.0.7230010.3.1.4.8323329.1139.1517875166.444702.png,442986,{},1,0,"{""name"":""rect"",""x"":53,""y"":118,""width"":914,""height"":785}",{},785,rect,914,53,118,/home/dianwen/SIIM_ACR/train/images/1024/dicom/1.2.276.0.7230010.3.1.4.8323329.1139.1517875166.444702.png,/home/dianwen/SIIM_ACR/train/images/1024/mask/1.2.276.0.7230010.3.1.4.8323329.1139.1517875166.444702.png,0.0,0.0,903,967
1.2.276.0.7230010.3.1.4.8323329.1140.1517875166.465295.png,337145,{},1,0,"{""name"":""rect"",""x"":168,""y"":133,""width"":734,""height"":881}",{},881,rect,734,168,133,/home/dianwen/SIIM_ACR/train/images/1024/dicom/1.2.276.0.7230010.3.1.4.8323329.1140.1517875166.465295.png,/home/dianwen/SIIM_ACR/train/images/1024/mask/1.2.276.0.7230010.3.1.4.8323329.1140.1517875166.465295.png,0.0034027099609375,1.0,1014,902
1.2.276.0.7230010.3.1.4.8323329.1141.1517875166.462272.png,329849,{},1,0,"{""name"":""rect"",""x"":129,""y"":144,""width"":779,""height"":834}",{},834,rect,779,129,144,/home/dianwen/SIIM_ACR/train/images/1024/dicom/1.2.276.0.7230010.3.1.4.8323329.1141.1517875166.462272.png,/home/dianwen/SIIM_ACR/train/images/1024/mask/1.2.276.0.7230010.3.1.4.8323329.1141.1517875166.462272.png,0.0,0.0,978,908
1.2.276.0.7230010.3.1.4.8323329.1142.1517875166.463093.png,443385,{},1,0,"{""name"":""rect"",""x"":89,""y"":134,""width"":877,""height"":850}",{},850,rect,877,89,134,/home/dianwen/SIIM_ACR/train/images/1024/dicom/1.2.276.0.7230010.3.1.4.8323329.1142.1517875166.463093.png,/home/dianwen/SIIM_ACR/train/images/1024/mask/1.2.276.0.7230010.3.1.4.8323329.1142.1517875166.463093.png,0.0,0.0,984,966
1.2.276.0.7230010.3.1.4.8323329.1143.1517875166.464727.png,328391,{},1,0,"{""name"":""rect"",""x"":73,""y"":120,""width"":899,""height"":835}",{},835,rect,899,73,120,/home/dianwen/SIIM_ACR/train/images/1024/dicom/1.2.276.0.7230010.3.1.4.8323329.1143.1517875166.464727.png,/home/dianwen/SIIM_ACR/train/images/1024/mask/1.2.276.0.7230010.3.1.4.8323329.1143.1517875166.464727.png,0.0,0.0,955,972
1.2.276.0.7230010.3.1.4.8323329.1144.1517875166.464567.png,433664,{},1,0,"{""name"":""rect"",""x"":82,""y"":112,""width"":859,""height"":898}",{},898,rect,859,82,112,/home/dianwen/SIIM_ACR/train/images/1024/dicom/1.2.276.0.7230010.3.1.4.8323329.1144.1517875166.464567.png,/home/dianwen/SIIM_ACR/train/images/1024/mask/1.2.276.0.7230010.3.1.4.8323329.1144.1517875166.464567.png,0.0,0.0,1010,941
1.2.276.0.7230010.3.1.4.8323329.1145.1517875166.470151.png,385511,{},1,0,"{""name"":""rect"",""x"":26,""y"":46,""width"":958,""height"":775}",{},775,rect,958,26,46,/home/dianwen/SIIM_ACR/train/images/1024/dicom/1.2.276.0.7230010.3.1.4.8323329.1145.1517875166.470151.png,/home/dianwen/SIIM_ACR/train/images/1024/mask/1.2.276.0.7230010.3.1.4.8323329.1145.1517875166.470151.png,0.0,0.0,821,984
1.2.276.0.7230010.3.1.4.8323329.1146.1517875166.475187.png,419431,{},1,0,"{""name"":""rect"",""x"":119,""y"":59,""width"":773,""height"":899}",{},899,rect,773,119,59,/home/dianwen/SIIM_ACR/train/images/1024/dicom/1.2.276.0.7230010.3.1.4.8323329.1146.1517875166.475187.png,/home/dianwen/SIIM_ACR/train/images/1024/mask/1.2.276.0.7230010.3.1.4.8323329.1146.1517875166.475187.png,0.0,0.0,958,892
1.2.276.0.7230010.3.1.4.8323329.1147.1517875166.485201.png,361962,{},1,0,"{""name"":""rect"",""x"":64,""y"":11,""width"":840,""height"":918}",{},918,rect,840,64,11,/home/dianwen/SIIM_ACR/train/images/1024/dicom/1.2.276.0.7230010.3.1.4.8323329.1147.1517875166.485201.png,/home/dianwen/SIIM_ACR/train/images/1024/mask/1.2.276.0.7230010.3.1.4.8323329.1147.1517875166.485201.png,0.0,0.0,929,904
1.2.276.0.7230010.3.1.4.8323329.1148.1517875166.497982.png,380190,{},1,0,"{""name"":""rect"",""x"":220,""y"":56,""width"":777,""height"":938}",{},938,rect,777,220,56,/home/dianwen/SIIM_ACR/train/images/1024/dicom/1.2.276.0.7230010.3.1.4.8323329.1148.1517875166.497982.png,/home/dianwen/SIIM_ACR/train/images/1024/mask/1.2.276.0.7230010.3.1.4.8323329.1148.1517875166.497982.png,0.0,0.0,994,997
1.2.276.0.7230010.3.1.4.8323329.1149.1517875166.489424.png,434956,{},1,0,"{""name"":""rect"",""x"":91,""y"":99,""width"":817,""height"":865}",{},865,rect,817,91,99,/home/dianwen/SIIM_ACR/train/images/1024/dicom/1.2.276.0.7230010.3.1.4.8323329.1149.1517875166.489424.png,/home/dianwen/SIIM_ACR/train/images/1024/mask/1.2.276.0.7230010.3.1.4.8323329.1149.1517875166.489424.png,0.0,0.0,964,908
1.2.276.0.7230010.3.1.4.8323329.1150.1517875166.498759.png,413379,{},1,0,"{""name"":""rect"",""x"":145,""y"":156,""width"":705,""height"":685}",{},685,rect,705,145,156,/home/dianwen/SIIM_ACR/train/images/1024/dicom/1.2.276.0.7230010.3.1.4.8323329.1150.1517875166.498759.png,/home/dianwen/SIIM_ACR/train/images/1024/mask/1.2.276.0.7230010.3.1.4.8323329.1150.1517875166.498759.png,0.0,0.0,841,850
1.2.276.0.7230010.3.1.4.8323329.1151.1517875166.497668.png,429446,{},1,0,"{""name"":""rect"",""x"":48,""y"":99,""width"":964,""height"":756}",{},756,rect,964,48,99,/home/dianwen/SIIM_ACR/train/images/1024/dicom/1.2.276.0.7230010.3.1.4.8323329.1151.1517875166.497668.png,/home/dianwen/SIIM_ACR/train/images/1024/mask/1.2.276.0.7230010.3.1.4.8323329.1151.1517875166.497668.png,0.0,0.0,855,1012
1.2.276.0.7230010.3.1.4.8323329.1152.1517875166.494725.png,313804,{},1,0,"{""name"":""rect"",""x"":168,""y"":140,""width"":699,""height"":677}",{},677,rect,699,168,140,/home/dianwen/SIIM_ACR/train/images/1024/dicom/1.2.276.0.7230010.3.1.4.8323329.1152.1517875166.494725.png,/home/dianwen/SIIM_ACR/train/images/1024/mask/1.2.276.0.7230010.3.1.4.8323329.1152.1517875166.494725.png,0.0,0.0,817,867
1.2.276.0.7230010.3.1.4.8323329.1153.1517875166.501237.png,412233,{},1,0,"{""name"":""rect"",""x"":152,""y"":52,""width"":733,""height"":826}",{},826,rect,733,152,52,/home/dianwen/SIIM_ACR/train/images/1024/dicom/1.2.276.0.7230010.3.1.4.8323329.1153.1517875166.501237.png,/home/dianwen/SIIM_ACR/train/images/1024/mask/1.2.276.0.7230010.3.1.4.8323329.1153.1517875166.501237.png,0.0,0.0,878,885
1.2.276.0.7230010.3.1.4.8323329.1154.1517875166.500614.png,353695,{},1,0,"{""name"":""rect"",""x"":173,""y"":230,""width"":762,""height"":791}",{},791,rect,762,173,230,/home/dianwen/SIIM_ACR/train/images/1024/dicom/1.2.276.0.7230010.3.1.4.8323329.1154.1517875166.500614.png,/home/dianwen/SIIM_ACR/train/images/1024/mask/1.2.276.0.7230010.3.1.4.8323329.1154.1517875166.500614.png,0.0,0.0,1021,935
1.2.276.0.7230010.3.1.4.8323329.1155.1517875166.510705.png,452552,{},1,0,"{""name"":""rect"",""x"":89,""y"":78,""width"":838,""height"":940}",{},940,rect,838,89,78,/home/dianwen/SIIM_ACR/train/images/1024/dicom/1.2.276.0.7230010.3.1.4.8323329.1155.1517875166.510705.png,/home/dianwen/SIIM_ACR/train/images/1024/mask/1.2.276.0.7230010.3.1.4.8323329.1155.1517875166.510705.png,0.0,0.0,1018,927
1.2.276.0.7230010.3.1.4.8323329.1156.1517875166.513917.png,433540,{},1,0,"{""name"":""rect"",""x"":46,""y"":156,""width"":942,""height"":725}",{},725,rect,942,46,156,/home/dianwen/SIIM_ACR/train/images/1024/dicom/1.2.276.0.7230010.3.1.4.8323329.1156.1517875166.513917.png,/home/dianwen/SIIM_ACR/train/images/1024/mask/1.2.276.0.7230010.3.1.4.8323329.1156.1517875166.513917.png,0.0,0.0,881,988
1.2.276.0.7230010.3.1.4.8323329.1157.1517875166.516622.png,327761,{},1,0,"{""name"":""rect"",""x"":228,""y"":128,""width"":748,""height"":810}",{},810,rect,748,228,128,/home/dianwen/SIIM_ACR/train/images/1024/dicom/1.2.276.0.7230010.3.1.4.8323329.1157.1517875166.516622.png,/home/dianwen/SIIM_ACR/train/images/1024/mask/1.2.276.0.7230010.3.1.4.8323329.1157.1517875166.516622.png,0.0,0.0,938,976
1.2.276.0.7230010.3.1.4.8323329.1158.1517875166.516788.png,357243,{},1,0,"{""name"":""rect"",""x"":72,""y"":69,""width"":739,""height"":928}",{},928,rect,739,72,69,/home/dianwen/SIIM_ACR/train/images/1024/dicom/1.2.276.0.7230010.3.1.4.8323329.1158.1517875166.516788.png,/home/dianwen/SIIM_ACR/train/images/1024/mask/1.2.276.0.7230010.3.1.4.8323329.1158.1517875166.516788.png,0.0,0.0,997,811
1.2.276.0.7230010.3.1.4.8323329.1159.1517875166.521328.png,414732,{},1,0,"{""name"":""rect"",""x"":164,""y"":147,""width"":751,""height"":777}",{},777,rect,751,164,147,/home/dianwen/SIIM_ACR/train/images/1024/dicom/1.2.276.0.7230010.3.1.4.8323329.1159.1517875166.521328.png,/home/dianwen/SIIM_ACR/train/images/1024/mask/1.2.276.0.7230010.3.1.4.8323329.1159.1517875166.521328.png,0.0,0.0,924,915
1.2.276.0.7230010.3.1.4.8323329.1160.1517875166.532133.png,386315,{},1,0,"{""name"":""rect"",""x"":41,""y"":45,""width"":829,""height"":958}",{},958,rect,829,41,45,/home/dianwen/SIIM_ACR/train/images/1024/dicom/1.2.276.0.7230010.3.1.4.8323329.1160.1517875166.532133.png,/home/dianwen/SIIM_ACR/train/images/1024/mask/1.2.276.0.7230010.3.1.4.8323329.1160.1517875166.532133.png,0.0,0.0,1003,870
1.2.276.0.7230010.3.1.4.8323329.1161.1517875166.535594.png,430475,{},1,0,"{""name"":""rect"",""x"":168,""y"":68,""width"":763,""height"":865}",{},865,rect,763,168,68,/home/dianwen/SIIM_ACR/train/images/1024/dicom/1.2.276.0.7230010.3.1.4.8323329.1161.1517875166.535594.png,/home/dianwen/SIIM_ACR/train/images/1024/mask/1.2.276.0.7230010.3.1.4.8323329.1161.1517875166.535594.png,0.0,0.0,933,931
1.2.276.0.7230010.3.1.4.8323329.1162.1517875166.537365.png,408637,{},1,0,"{""name"":""rect"",""x"":193,""y"":35,""width"":760,""height"":861}",{},861,rect,760,193,35,/home/dianwen/SIIM_ACR/train/images/1024/dicom/1.2.276.0.7230010.3.1.4.8323329.1162.1517875166.537365.png,/home/dianwen/SIIM_ACR/train/images/1024/mask/1.2.276.0.7230010.3.1.4.8323329.1162.1517875166.537365.png,0.0,0.0,896,953
1.2.276.0.7230010.3.1.4.8323329.1163.1517875166.557263.png,426458,{},1,0,"{""name"":""rect"",""x"":78,""y"":70,""width"":878,""height"":706}",{},706,rect,878,78,70,/home/dianwen/SIIM_ACR/train/images/1024/dicom/1.2.276.0.7230010.3.1.4.8323329.1163.1517875166.557263.png,/home/dianwen/SIIM_ACR/train/images/1024/mask/1.2.276.0.7230010.3.1.4.8323329.1163.1517875166.557263.png,0.0,0.0,776,956
1.2.276.0.7230010.3.1.4.8323329.1164.1517875166.564299.png,455282,{},1,0,"{""name"":""rect"",""x"":53,""y"":69,""width"":927,""height"":809}",{},809,rect,927,53,69,/home/dianwen/SIIM_ACR/train/images/1024/dicom/1.2.276.0.7230010.3.1.4.8323329.1164.1517875166.564299.png,/home/dianwen/SIIM_ACR/train/images/1024/mask/1.2.276.0.7230010.3.1.4.8323329.1164.1517875166.564299.png,0.005261421203613281,1.0,878,980
1.2.276.0.7230010.3.1.4.8323329.1165.1517875166.571167.png,303707,{},1,0,"{""name"":""rect"",""x"":171,""y"":102,""width"":716,""height"":668}",{},668,rect,716,171,102,/home/dianwen/SIIM_ACR/train/images/1024/dicom/1.2.276.0.7230010.3.1.4.8323329.1165.1517875166.571167.png,/home/dianwen/SIIM_ACR/train/images/1024/mask/1.2.276.0.7230010.3.1.4.8323329.1165.1517875166.571167.png,0.004626274108886719,1.0,770,887
1.2.276.0.7230010.3.1.4.8323329.1166.1517875166.578202.png,398365,{},1,0,"{""name"":""rect"",""x"":87,""y"":51,""width"":799,""height"":873}",{},873,rect,799,87,51,/home/dianwen/SIIM_ACR/train/images/1024/dicom/1.2.276.0.7230010.3.1.4.8323329.1166.1517875166.578202.png,/home/dianwen/SIIM_ACR/train/images/1024/mask/1.2.276.0.7230010.3.1.4.8323329.1166.1517875166.578202.png,0.009927749633789062,1.0,924,886
1.2.276.0.7230010.3.1.4.8323329.1167.1517875166.598246.png,360321,{},1,0,"{""name"":""rect"",""x"":153,""y"":194,""width"":775,""height"":804}",{},804,rect,775,153,194,/home/dianwen/SIIM_ACR/train/images/1024/dicom/1.2.276.0.7230010.3.1.4.8323329.1167.1517875166.598246.png,/home/dianwen/SIIM_ACR/train/images/1024/mask/1.2.276.0.7230010.3.1.4.8323329.1167.1517875166.598246.png,0.0,0.0,998,928
1.2.276.0.7230010.3.1.4.8323329.1168.1517875166.599906.png,365342,{},1,0,"{""name"":""rect"",""x"":147,""y"":111,""width"":752,""height"":726}",{},726,rect,752,147,111,/home/dianwen/SIIM_ACR/train/images/1024/dicom/1.2.276.0.7230010.3.1.4.8323329.1168.1517875166.599906.png,/home/dianwen/SIIM_ACR/train/images/1024/mask/1.2.276.0.7230010.3.1.4.8323329.1168.1517875166.599906.png,0.01606464385986328,1.0,837,899
1.2.276.0.7230010.3.1.4.8323329.1169.1517875166.603496.png,443285,{},1,0,"{""name"":""rect"",""x"":110,""y"":73,""width"":840,""height"":865}",{},865,rect,840,110,73,/home/dianwen/SIIM_ACR/train/images/1024/dicom/1.2.276.0.7230010.3.1.4.8323329.1169.1517875166.603496.png,/home/dianwen/SIIM_ACR/train/images/1024/mask/1.2.276.0.7230010.3.1.4.8323329.1169.1517875166.603496.png,0.0,0.0,938,950
1.2.276.0.7230010.3.1.4.8323329.1170.1517875166.613486.png,380748,{},1,0,"{""name"":""rect"",""x"":84,""y"":142,""width"":808,""height"":879}",{},879,rect,808,84,142,/home/dianwen/SIIM_ACR/train/images/1024/dicom/1.2.276.0.7230010.3.1.4.8323329.1170.1517875166.613486.png,/home/dianwen/SIIM_ACR/train/images/1024/mask/1.2.276.0.7230010.3.1.4.8323329.1170.1517875166.613486.png,0.0,0.0,1021,892
1.2.276.0.7230010.3.1.4.8323329.1172.1517875166.624365.png,360981,{},1,0,"{""name"":""rect"",""x"":63,""y"":56,""width"":790,""height"":965}",{},965,rect,790,63,56,/home/dianwen/SIIM_ACR/train/images/1024/dicom/1.2.276.0.7230010.3.1.4.8323329.1172.1517875166.624365.png,/home/dianwen/SIIM_ACR/train/images/1024/mask/1.2.276.0.7230010.3.1.4.8323329.1172.1517875166.624365.png,0.0,0.0,1021,853
1.2.276.0.7230010.3.1.4.8323329.1173.1517875166.626582.png,406108,{},1,0,"{""name"":""rect"",""x"":95,""y"":41,""width"":846,""height"":939}",{},939,rect,846,95,41,/home/dianwen/SIIM_ACR/train/images/1024/dicom/1.2.276.0.7230010.3.1.4.8323329.1173.1517875166.626582.png,/home/dianwen/SIIM_ACR/train/images/1024/mask/1.2.276.0.7230010.3.1.4.8323329.1173.1517875166.626582.png,0.005133628845214844,1.0,980,941
1.2.276.0.7230010.3.1.4.8323329.1174.1517875166.639867.png,366327,{},1,0,"{""name"":""rect"",""x"":105,""y"":75,""width"":850,""height"":915}",{},915,rect,850,105,75,/home/dianwen/SIIM_ACR/train/images/1024/dicom/1.2.276.0.7230010.3.1.4.8323329.1174.1517875166.639867.png,/home/dianwen/SIIM_ACR/train/images/1024/mask/1.2.276.0.7230010.3.1.4.8323329.1174.1517875166.639867.png,0.0,0.0,990,955
1.2.276.0.7230010.3.1.4.8323329.1175.1517875166.658868.png,352849,{},1,0,"{""name"":""rect"",""x"":223,""y"":94,""width"":650,""height"":830}",{},830,rect,650,223,94,/home/dianwen/SIIM_ACR/train/images/1024/dicom/1.2.276.0.7230010.3.1.4.8323329.1175.1517875166.658868.png,/home/dianwen/SIIM_ACR/train/images/1024/mask/1.2.276.0.7230010.3.1.4.8323329.1175.1517875166.658868.png,0.0,0.0,924,873
1.2.276.0.7230010.3.1.4.8323329.1176.1517875166.647850.png,403976,{},1,0,"{""name"":""rect"",""x"":130,""y"":217,""width"":725,""height"":623}",{},623,rect,725,130,217,/home/dianwen/SIIM_ACR/train/images/1024/dicom/1.2.276.0.7230010.3.1.4.8323329.1176.1517875166.647850.png,/home/dianwen/SIIM_ACR/train/images/1024/mask/1.2.276.0.7230010.3.1.4.8323329.1176.1517875166.647850.png,0.0,0.0,840,855
1.2.276.0.7230010.3.1.4.8323329.1177.1517875166.651360.png,426464,{},1,0,"{""name"":""rect"",""x"":87,""y"":43,""width"":804,""height"":785}",{},785,rect,804,87,43,/home/dianwen/SIIM_ACR/train/images/1024/dicom/1.2.276.0.7230010.3.1.4.8323329.1177.1517875166.651360.png,/home/dianwen/SIIM_ACR/train/images/1024/mask/1.2.276.0.7230010.3.1.4.8323329.1177.1517875166.651360.png,0.0,0.0,828,891
1.2.276.0.7230010.3.1.4.8323329.1178.1517875166.652016.png,427093,{},1,0,"{""name"":""rect"",""x"":84,""y"":122,""width"":847,""height"":690}",{},690,rect,847,84,122,/home/dianwen/SIIM_ACR/train/images/1024/dicom/1.2.276.0.7230010.3.1.4.8323329.1178.1517875166.652016.png,/home/dianwen/SIIM_ACR/train/images/1024/mask/1.2.276.0.7230010.3.1.4.8323329.1178.1517875166.652016.png,0.0,0.0,812,931
1.2.276.0.7230010.3.1.4.8323329.1179.1517875166.661223.png,410679,{},1,0,"{""name"":""rect"",""x"":135,""y"":60,""width"":827,""height"":920}",{},920,rect,827,135,60,/home/dianwen/SIIM_ACR/train/images/1024/dicom/1.2.276.0.7230010.3.1.4.8323329.1179.1517875166.661223.png,/home/dianwen/SIIM_ACR/train/images/1024/mask/1.2.276.0.7230010.3.1.4.8323329.1179.1517875166.661223.png,0.0,0.0,980,962
1.2.276.0.7230010.3.1.4.8323329.1181.1517875166.667637.png,438475,{},1,0,"{""name"":""rect"",""x"":65,""y"":79,""width"":771,""height"":718}",{},718,rect,771,65,79,/home/dianwen/SIIM_ACR/train/images/1024/dicom/1.2.276.0.7230010.3.1.4.8323329.1181.1517875166.667637.png,/home/dianwen/SIIM_ACR/train/images/1024/mask/1.2.276.0.7230010.3.1.4.8323329.1181.1517875166.667637.png,0.003935813903808594,1.0,797,836
1.2.276.0.7230010.3.1.4.8323329.1182.1517875166.681377.png,419008,{},1,0,"{""name"":""rect"",""x"":89,""y"":123,""width"":846,""height"":890}",{},890,rect,846,89,123,/home/dianwen/SIIM_ACR/train/images/1024/dicom/1.2.276.0.7230010.3.1.4.8323329.1182.1517875166.681377.png,/home/dianwen/SIIM_ACR/train/images/1024/mask/1.2.276.0.7230010.3.1.4.8323329.1182.1517875166.681377.png,0.0,0.0,1013,935
1.2.276.0.7230010.3.1.4.8323329.1185.1517875166.703494.png,446607,{},1,0,"{""name"":""rect"",""x"":10,""y"":95,""width"":1000,""height"":828}",{},828,rect,1000,10,95,/home/dianwen/SIIM_ACR/train/images/1024/dicom/1.2.276.0.7230010.3.1.4.8323329.1185.1517875166.703494.png,/home/dianwen/SIIM_ACR/train/images/1024/mask/1.2.276.0.7230010.3.1.4.8323329.1185.1517875166.703494.png,0.0,0.0,923,1010
1.2.276.0.7230010.3.1.4.8323329.1187.1517875166.691986.png,348999,{},1,0,"{""name"":""rect"",""x"":167,""y"":126,""width"":665,""height"":827}",{},827,rect,665,167,126,/home/dianwen/SIIM_ACR/train/images/1024/dicom/1.2.276.0.7230010.3.1.4.8323329.1187.1517875166.691986.png,/home/dianwen/SIIM_ACR/train/images/1024/mask/1.2.276.0.7230010.3.1.4.8323329.1187.1517875166.691986.png,0.02741909027099609,1.0,953,832
1.2.276.0.7230010.3.1.4.8323329.1188.1517875166.696749.png,314526,{},1,0,"{""name"":""rect"",""x"":200,""y"":66,""width"":682,""height"":792}",{},792,rect,682,200,66,/home/dianwen/SIIM_ACR/train/images/1024/dicom/1.2.276.0.7230010.3.1.4.8323329.1188.1517875166.696749.png,/home/dianwen/SIIM_ACR/train/images/1024/mask/1.2.276.0.7230010.3.1.4.8323329.1188.1517875166.696749.png,0.0,0.0,858,882
1.2.276.0.7230010.3.1.4.8323329.1189.1517875166.706591.png,352596,{},1,0,"{""name"":""rect"",""x"":147,""y"":118,""width"":770,""height"":775}",{},775,rect,770,147,118,/home/dianwen/SIIM_ACR/train/images/1024/dicom/1.2.276.0.7230010.3.1.4.8323329.1189.1517875166.706591.png,/home/dianwen/SIIM_ACR/train/images/1024/mask/1.2.276.0.7230010.3.1.4.8323329.1189.1517875166.706591.png,0.0,0.0,893,917
1.2.276.0.7230010.3.1.4.8323329.1190.1517875166.710435.png,431672,{},1,0,"{""name"":""rect"",""x"":32,""y"":83,""width"":889,""height"":830}",{},830,rect,889,32,83,/home/dianwen/SIIM_ACR/train/images/1024/dicom/1.2.276.0.7230010.3.1.4.8323329.1190.1517875166.710435.png,/home/dianwen/SIIM_ACR/train/images/1024/mask/1.2.276.0.7230010.3.1.4.8323329.1190.1517875166.710435.png,0.0,0.0,913,921
1.2.276.0.7230010.3.1.4.8323329.1191.1517875166.717187.png,341591,{},1,0,"{""name"":""rect"",""x"":184,""y"":26,""width"":689,""height"":769}",{},769,rect,689,184,26,/home/dianwen/SIIM_ACR/train/images/1024/dicom/1.2.276.0.7230010.3.1.4.8323329.1191.1517875166.717187.png,/home/dianwen/SIIM_ACR/train/images/1024/mask/1.2.276.0.7230010.3.1.4.8323329.1191.1517875166.717187.png,0.0027484893798828125,1.0,795,873
1.2.276.0.7230010.3.1.4.8323329.1192.1517875166.729540.png,335503,{},1,0,"{""name"":""rect"",""x"":109,""y"":147,""width"":859,""height"":697}",{},697,rect,859,109,147,/home/dianwen/SIIM_ACR/train/images/1024/dicom/1.2.276.0.7230010.3.1.4.8323329.1192.1517875166.729540.png,/home/dianwen/SIIM_ACR/train/images/1024/mask/1.2.276.0.7230010.3.1.4.8323329.1192.1517875166.729540.png,0.0,0.0,844,968
1.2.276.0.7230010.3.1.4.8323329.1193.1517875166.729329.png,354693,{},1,0,"{""name"":""rect"",""x"":167,""y"":96,""width"":716,""height"":905}",{},905,rect,716,167,96,/home/dianwen/SIIM_ACR/train/images/1024/dicom/1.2.276.0.7230010.3.1.4.8323329.1193.1517875166.729329.png,/home/dianwen/SIIM_ACR/train/images/1024/mask/1.2.276.0.7230010.3.1.4.8323329.1193.1517875166.729329.png,0.0,0.0,1001,883
1.2.276.0.7230010.3.1.4.8323329.1194.1517875166.726624.png,418126,{},1,0,"{""name"":""rect"",""x"":154,""y"":58,""width"":743,""height"":936}",{},936,rect,743,154,58,/home/dianwen/SIIM_ACR/train/images/1024/dicom/1.2.276.0.7230010.3.1.4.8323329.1194.1517875166.726624.png,/home/dianwen/SIIM_ACR/train/images/1024/mask/1.2.276.0.7230010.3.1.4.8323329.1194.1517875166.726624.png,0.0,0.0,994,897
1.2.276.0.7230010.3.1.4.8323329.1195.1517875166.750726.png,384532,{},1,0,"{""name"":""rect"",""x"":1,""y"":52,""width"":674,""height"":808}",{},808,rect,674,1,52,/home/dianwen/SIIM_ACR/train/images/1024/dicom/1.2.276.0.7230010.3.1.4.8323329.1195.1517875166.750726.png,/home/dianwen/SIIM_ACR/train/images/1024/mask/1.2.276.0.7230010.3.1.4.8323329.1195.1517875166.750726.png,0.0,0.0,860,675
1.2.276.0.7230010.3.1.4.8323329.1196.1517875166.750478.png,451575,{},1,0,"{""name"":""rect"",""x"":8,""y"":86,""width"":975,""height"":894}",{},894,rect,975,8,86,/home/dianwen/SIIM_ACR/train/images/1024/dicom/1.2.276.0.7230010.3.1.4.8323329.1196.1517875166.750478.png,/home/dianwen/SIIM_ACR/train/images/1024/mask/1.2.276.0.7230010.3.1.4.8323329.1196.1517875166.750478.png,0.0,0.0,980,983
1.2.276.0.7230010.3.1.4.8323329.1197.1517875166.749284.png,371449,{},1,0,"{""name"":""rect"",""x"":92,""y"":53,""width"":778,""height"":808}",{},808,rect,778,92,53,/home/dianwen/SIIM_ACR/train/images/1024/dicom/1.2.276.0.7230010.3.1.4.8323329.1197.1517875166.749284.png,/home/dianwen/SIIM_ACR/train/images/1024/mask/1.2.276.0.7230010.3.1.4.8323329.1197.1517875166.749284.png,0.0,0.0,861,870
1.2.276.0.7230010.3.1.4.8323329.1198.1517875166.754999.png,409638,{},1,0,"{""name"":""rect"",""x"":6,""y"":78,""width"":993,""height"":898}",{},898,rect,993,6,78,/home/dianwen/SIIM_ACR/train/images/1024/dicom/1.2.276.0.7230010.3.1.4.8323329.1198.1517875166.754999.png,/home/dianwen/SIIM_ACR/train/images/1024/mask/1.2.276.0.7230010.3.1.4.8323329.1198.1517875166.754999.png,0.03716754913330078,1.0,976,999
1.2.276.0.7230010.3.1.4.8323329.1200.1517875166.758686.png,443226,{},1,0,"{""name"":""rect"",""x"":31,""y"":121,""width"":967,""height"":871}",{},871,rect,967,31,121,/home/dianwen/SIIM_ACR/train/images/1024/dicom/1.2.276.0.7230010.3.1.4.8323329.1200.1517875166.758686.png,/home/dianwen/SIIM_ACR/train/images/1024/mask/1.2.276.0.7230010.3.1.4.8323329.1200.1517875166.758686.png,0.0,0.0,992,998
1.2.276.0.7230010.3.1.4.8323329.1202.1517875166.747008.png,430343,{},1,0,"{""name"":""rect"",""x"":128,""y"":112,""width"":765,""height"":711}",{},711,rect,765,128,112,/home/dianwen/SIIM_ACR/train/images/1024/dicom/1.2.276.0.7230010.3.1.4.8323329.1202.1517875166.747008.png,/home/dianwen/SIIM_ACR/train/images/1024/mask/1.2.276.0.7230010.3.1.4.8323329.1202.1517875166.747008.png,0.0,0.0,823,893
1.2.276.0.7230010.3.1.4.8323329.1203.1517875166.746948.png,370744,{},1,0,"{""name"":""rect"",""x"":21,""y"":84,""width"":906,""height"":813}",{},813,rect,906,21,84,/home/dianwen/SIIM_ACR/train/images/1024/dicom/1.2.276.0.7230010.3.1.4.8323329.1203.1517875166.746948.png,/home/dianwen/SIIM_ACR/train/images/1024/mask/1.2.276.0.7230010.3.1.4.8323329.1203.1517875166.746948.png,0.0,0.0,897,927
1.2.276.0.7230010.3.1.4.8323329.1204.1517875166.753950.png,433621,{},1,0,"{""name"":""rect"",""x"":36,""y"":174,""width"":950,""height"":790}",{},790,rect,950,36,174,/home/dianwen/SIIM_ACR/train/images/1024/dicom/1.2.276.0.7230010.3.1.4.8323329.1204.1517875166.753950.png,/home/dianwen/SIIM_ACR/train/images/1024/mask/1.2.276.0.7230010.3.1.4.8323329.1204.1517875166.753950.png,0.0,0.0,964,986
1.2.276.0.7230010.3.1.4.8323329.1205.1517875166.762158.png,400655,{},1,0,"{""name"":""rect"",""x"":76,""y"":113,""width"":814,""height"":871}",{},871,rect,814,76,113,/home/dianwen/SIIM_ACR/train/images/1024/dicom/1.2.276.0.7230010.3.1.4.8323329.1205.1517875166.762158.png,/home/dianwen/SIIM_ACR/train/images/1024/mask/1.2.276.0.7230010.3.1.4.8323329.1205.1517875166.762158.png,0.0,0.0,984,890
1.2.276.0.7230010.3.1.4.8323329.1206.1517875166.766269.png,360862,{},1,0,"{""name"":""rect"",""x"":210,""y"":123,""width"":654,""height"":651}",{},651,rect,654,210,123,/home/dianwen/SIIM_ACR/train/images/1024/dicom/1.2.276.0.7230010.3.1.4.8323329.1206.1517875166.766269.png,/home/dianwen/SIIM_ACR/train/images/1024/mask/1.2.276.0.7230010.3.1.4.8323329.1206.1517875166.766269.png,0.0,0.0,774,864
1.2.276.0.7230010.3.1.4.8323329.1207.1517875166.781091.png,416084,{},1,0,"{""name"":""rect"",""x"":244,""y"":33,""width"":700,""height"":780}",{},780,rect,700,244,33,/home/dianwen/SIIM_ACR/train/images/1024/dicom/1.2.276.0.7230010.3.1.4.8323329.1207.1517875166.781091.png,/home/dianwen/SIIM_ACR/train/images/1024/mask/1.2.276.0.7230010.3.1.4.8323329.1207.1517875166.781091.png,0.005910873413085938,1.0,813,944
1.2.276.0.7230010.3.1.4.8323329.1208.1517875166.774484.png,409769,{},1,0,"{""name"":""rect"",""x"":14,""y"":68,""width"":863,""height"":803}",{},803,rect,863,14,68,/home/dianwen/SIIM_ACR/train/images/1024/dicom/1.2.276.0.7230010.3.1.4.8323329.1208.1517875166.774484.png,/home/dianwen/SIIM_ACR/train/images/1024/mask/1.2.276.0.7230010.3.1.4.8323329.1208.1517875166.774484.png,0.0,0.0,871,877
1.2.276.0.7230010.3.1.4.8323329.1209.1517875166.788484.png,422570,{},1,0,"{""name"":""rect"",""x"":100,""y"":46,""width"":810,""height"":777}",{},777,rect,810,100,46,/home/dianwen/SIIM_ACR/train/images/1024/dicom/1.2.276.0.7230010.3.1.4.8323329.1209.1517875166.788484.png,/home/dianwen/SIIM_ACR/train/images/1024/mask/1.2.276.0.7230010.3.1.4.8323329.1209.1517875166.788484.png,0.0,0.0,823,910
1.2.276.0.7230010.3.1.4.8323329.1210.1517875166.793787.png,407155,{},1,0,"{""name"":""rect"",""x"":153,""y"":139,""width"":809,""height"":699}",{},699,rect,809,153,139,/home/dianwen/SIIM_ACR/train/images/1024/dicom/1.2.276.0.7230010.3.1.4.8323329.1210.1517875166.793787.png,/home/dianwen/SIIM_ACR/train/images/1024/mask/1.2.276.0.7230010.3.1.4.8323329.1210.1517875166.793787.png,0.0,0.0,838,962
1.2.276.0.7230010.3.1.4.8323329.1211.1517875166.797054.png,427680,{},1,0,"{""name"":""rect"",""x"":122,""y"":101,""width"":753,""height"":751}",{},751,rect,753,122,101,/home/dianwen/SIIM_ACR/train/images/1024/dicom/1.2.276.0.7230010.3.1.4.8323329.1211.1517875166.797054.png,/home/dianwen/SIIM_ACR/train/images/1024/mask/1.2.276.0.7230010.3.1.4.8323329.1211.1517875166.797054.png,0.0,0.0,852,875
1.2.276.0.7230010.3.1.4.8323329.1212.1517875166.819496.png,338688,{},1,0,"{""name"":""rect"",""x"":80,""y"":133,""width"":818,""height"":888}",{},888,rect,818,80,133,/home/dianwen/SIIM_ACR/train/images/1024/dicom/1.2.276.0.7230010.3.1.4.8323329.1212.1517875166.819496.png,/home/dianwen/SIIM_ACR/train/images/1024/mask/1.2.276.0.7230010.3.1.4.8323329.1212.1517875166.819496.png,0.0,0.0,1021,898
1.2.276.0.7230010.3.1.4.8323329.1213.1517875166.807170.png,316507,{},1,0,"{""name"":""rect"",""x"":3,""y"":103,""width"":746,""height"":805}",{},805,rect,746,3,103,/home/dianwen/SIIM_ACR/train/images/1024/dicom/1.2.276.0.7230010.3.1.4.8323329.1213.1517875166.807170.png,/home/dianwen/SIIM_ACR/train/images/1024/mask/1.2.276.0.7230010.3.1.4.8323329.1213.1517875166.807170.png,0.0,0.0,908,749
1.2.276.0.7230010.3.1.4.8323329.1214.1517875166.812240.png,348202,{},1,0,"{""name"":""rect"",""x"":151,""y"":45,""width"":818,""height"":831}",{},831,rect,818,151,45,/home/dianwen/SIIM_ACR/train/images/1024/dicom/1.2.276.0.7230010.3.1.4.8323329.1214.1517875166.812240.png,/home/dianwen/SIIM_ACR/train/images/1024/mask/1.2.276.0.7230010.3.1.4.8323329.1214.1517875166.812240.png,0.0,0.0,876,969
1.2.276.0.7230010.3.1.4.8323329.1215.1517875166.817758.png,412462,{},1,0,"{""name"":""rect"",""x"":87,""y"":20,""width"":767,""height"":782}",{},782,rect,767,87,20,/home/dianwen/SIIM_ACR/train/images/1024/dicom/1.2.276.0.7230010.3.1.4.8323329.1215.1517875166.817758.png,/home/dianwen/SIIM_ACR/train/images/1024/mask/1.2.276.0.7230010.3.1.4.8323329.1215.1517875166.817758.png,0.0,0.0,802,854
1.2.276.0.7230010.3.1.4.8323329.1216.1517875166.822321.png,397141,{},1,0,"{""name"":""rect"",""x"":97,""y"":18,""width"":870,""height"":779}",{},779,rect,870,97,18,/home/dianwen/SIIM_ACR/train/images/1024/dicom/1.2.276.0.7230010.3.1.4.8323329.1216.1517875166.822321.png,/home/dianwen/SIIM_ACR/train/images/1024/mask/1.2.276.0.7230010.3.1.4.8323329.1216.1517875166.822321.png,0.00935649871826172,1.0,797,967
1.2.276.0.7230010.3.1.4.8323329.1217.1517875166.828219.png,425003,{},1,0,"{""name"":""rect"",""x"":17,""y"":133,""width"":884,""height"":746}",{},746,rect,884,17,133,/home/dianwen/SIIM_ACR/train/images/1024/dicom/1.2.276.0.7230010.3.1.4.8323329.1217.1517875166.828219.png,/home/dianwen/SIIM_ACR/train/images/1024/mask/1.2.276.0.7230010.3.1.4.8323329.1217.1517875166.828219.png,0.0,0.0,879,901
1.2.276.0.7230010.3.1.4.8323329.1218.1517875166.835029.png,361829,{},1,0,"{""name"":""rect"",""x"":9,""y"":151,""width"":945,""height"":844}",{},844,rect,945,9,151,/home/dianwen/SIIM_ACR/train/images/1024/dicom/1.2.276.0.7230010.3.1.4.8323329.1218.1517875166.835029.png,/home/dianwen/SIIM_ACR/train/images/1024/mask/1.2.276.0.7230010.3.1.4.8323329.1218.1517875166.835029.png,0.0,0.0,995,954
1.2.276.0.7230010.3.1.4.8323329.1219.1517875166.835208.png,380281,{},1,0,"{""name"":""rect"",""x"":164,""y"":111,""width"":777,""height"":908}",{},908,rect,777,164,111,/home/dianwen/SIIM_ACR/train/images/1024/dicom/1.2.276.0.7230010.3.1.4.8323329.1219.1517875166.835208.png,/home/dianwen/SIIM_ACR/train/images/1024/mask/1.2.276.0.7230010.3.1.4.8323329.1219.1517875166.835208.png,0.0,0.0,1019,941
1.2.276.0.7230010.3.1.4.8323329.1220.1517875166.837537.png,442451,{},1,0,"{""name"":""rect"",""x"":50,""y"":97,""width"":944,""height"":829}",{},829,rect,944,50,97,/home/dianwen/SIIM_ACR/train/images/1024/dicom/1.2.276.0.7230010.3.1.4.8323329.1220.1517875166.837537.png,/home/dianwen/SIIM_ACR/train/images/1024/mask/1.2.276.0.7230010.3.1.4.8323329.1220.1517875166.837537.png,0.0,0.0,926,994
1.2.276.0.7230010.3.1.4.8323329.1221.1517875166.844950.png,367252,{},1,0,"{""name"":""rect"",""x"":148,""y"":139,""width"":714,""height"":733}",{},733,rect,714,148,139,/home/dianwen/SIIM_ACR/train/images/1024/dicom/1.2.276.0.7230010.3.1.4.8323329.1221.1517875166.844950.png,/home/dianwen/SIIM_ACR/train/images/1024/mask/1.2.276.0.7230010.3.1.4.8323329.1221.1517875166.844950.png,0.0,0.0,872,862
1.2.276.0.7230010.3.1.4.8323329.1222.1517875166.842991.png,294921,{},1,0,"{""name"":""rect"",""x"":304,""y"":55,""width"":715,""height"":893}",{},893,rect,715,304,55,/home/dianwen/SIIM_ACR/train/images/1024/dicom/1.2.276.0.7230010.3.1.4.8323329.1222.1517875166.842991.png,/home/dianwen/SIIM_ACR/train/images/1024/mask/1.2.276.0.7230010.3.1.4.8323329.1222.1517875166.842991.png,0.0,0.0,948,1019
1.2.276.0.7230010.3.1.4.8323329.1223.1517875166.847916.png,346628,{},1,0,"{""name"":""rect"",""x"":143,""y"":54,""width"":808,""height"":825}",{},825,rect,808,143,54,/home/dianwen/SIIM_ACR/train/images/1024/dicom/1.2.276.0.7230010.3.1.4.8323329.1223.1517875166.847916.png,/home/dianwen/SIIM_ACR/train/images/1024/mask/1.2.276.0.7230010.3.1.4.8323329.1223.1517875166.847916.png,0.000885009765625,1.0,879,951
1.2.276.0.7230010.3.1.4.8323329.1225.1517875166.858196.png,427283,{},1,0,"{""name"":""rect"",""x"":86,""y"":127,""width"":783,""height"":895}",{},895,rect,783,86,127,/home/dianwen/SIIM_ACR/train/images/1024/dicom/1.2.276.0.7230010.3.1.4.8323329.1225.1517875166.858196.png,/home/dianwen/SIIM_ACR/train/images/1024/mask/1.2.276.0.7230010.3.1.4.8323329.1225.1517875166.858196.png,0.01169109344482422,1.0,1022,869
1.2.276.0.7230010.3.1.4.8323329.1226.1517875166.862141.png,242659,{},1,0,"{""name"":""rect"",""x"":198,""y"":206,""width"":637,""height"":517}",{},517,rect,637,198,206,/home/dianwen/SIIM_ACR/train/images/1024/dicom/1.2.276.0.7230010.3.1.4.8323329.1226.1517875166.862141.png,/home/dianwen/SIIM_ACR/train/images/1024/mask/1.2.276.0.7230010.3.1.4.8323329.1226.1517875166.862141.png,0.0,0.0,723,835
1.2.276.0.7230010.3.1.4.8323329.1227.1517875166.865613.png,378502,{},1,0,"{""name"":""rect"",""x"":145,""y"":215,""width"":750,""height"":799}",{},799,rect,750,145,215,/home/dianwen/SIIM_ACR/train/images/1024/dicom/1.2.276.0.7230010.3.1.4.8323329.1227.1517875166.865613.png,/home/dianwen/SIIM_ACR/train/images/1024/mask/1.2.276.0.7230010.3.1.4.8323329.1227.1517875166.865613.png,0.0,0.0,1014,895
1.2.276.0.7230010.3.1.4.8323329.1228.1517875166.868196.png,424741,{},1,0,"{""name"":""rect"",""x"":150,""y"":56,""width"":751,""height"":677}",{},677,rect,751,150,56,/home/dianwen/SIIM_ACR/train/images/1024/dicom/1.2.276.0.7230010.3.1.4.8323329.1228.1517875166.868196.png,/home/dianwen/SIIM_ACR/train/images/1024/mask/1.2.276.0.7230010.3.1.4.8323329.1228.1517875166.868196.png,0.0,0.0,733,901
1.2.276.0.7230010.3.1.4.8323329.1229.1517875166.872911.png,299855,{},1,0,"{""name"":""rect"",""x"":272,""y"":167,""width"":726,""height"":853}",{},853,rect,726,272,167,/home/dianwen/SIIM_ACR/train/images/1024/dicom/1.2.276.0.7230010.3.1.4.8323329.1229.1517875166.872911.png,/home/dianwen/SIIM_ACR/train/images/1024/mask/1.2.276.0.7230010.3.1.4.8323329.1229.1517875166.872911.png,0.007476806640625,1.0,1020,998
1.2.276.0.7230010.3.1.4.8323329.1230.1517875166.881841.png,392241,{},1,0,"{""name"":""rect"",""x"":74,""y"":73,""width"":808,""height"":827}",{},827,rect,808,74,73,/home/dianwen/SIIM_ACR/train/images/1024/dicom/1.2.276.0.7230010.3.1.4.8323329.1230.1517875166.881841.png,/home/dianwen/SIIM_ACR/train/images/1024/mask/1.2.276.0.7230010.3.1.4.8323329.1230.1517875166.881841.png,0.0,0.0,900,882
1.2.276.0.7230010.3.1.4.8323329.1231.1517875166.883143.png,252942,{},1,0,"{""name"":""rect"",""x"":64,""y"":291,""width"":697,""height"":495}",{},495,rect,697,64,291,/home/dianwen/SIIM_ACR/train/images/1024/dicom/1.2.276.0.7230010.3.1.4.8323329.1231.1517875166.883143.png,/home/dianwen/SIIM_ACR/train/images/1024/mask/1.2.276.0.7230010.3.1.4.8323329.1231.1517875166.883143.png,0.0,0.0,786,761
1.2.276.0.7230010.3.1.4.8323329.1232.1517875166.883693.png,394936,{},1,0,"{""name"":""rect"",""x"":53,""y"":24,""width"":863,""height"":871}",{},871,rect,863,53,24,/home/dianwen/SIIM_ACR/train/images/1024/dicom/1.2.276.0.7230010.3.1.4.8323329.1232.1517875166.883693.png,/home/dianwen/SIIM_ACR/train/images/1024/mask/1.2.276.0.7230010.3.1.4.8323329.1232.1517875166.883693.png,0.0,0.0,895,916
1.2.276.0.7230010.3.1.4.8323329.1233.1517875166.884840.png,425025,{},1,0,"{""name"":""rect"",""x"":74,""y"":128,""width"":829,""height"":787}",{},787,rect,829,74,128,/home/dianwen/SIIM_ACR/train/images/1024/dicom/1.2.276.0.7230010.3.1.4.8323329.1233.1517875166.884840.png,/home/dianwen/SIIM_ACR/train/images/1024/mask/1.2.276.0.7230010.3.1.4.8323329.1233.1517875166.884840.png,0.0,0.0,915,903
1.2.276.0.7230010.3.1.4.8323329.1234.1517875166.893452.png,425062,{},1,0,"{""name"":""rect"",""x"":127,""y"":62,""width"":799,""height"":811}",{},811,rect,799,127,62,/home/dianwen/SIIM_ACR/train/images/1024/dicom/1.2.276.0.7230010.3.1.4.8323329.1234.1517875166.893452.png,/home/dianwen/SIIM_ACR/train/images/1024/mask/1.2.276.0.7230010.3.1.4.8323329.1234.1517875166.893452.png,0.0,0.0,873,926
1.2.276.0.7230010.3.1.4.8323329.1235.1517875166.903964.png,308804,{},1,0,"{""name"":""rect"",""x"":183,""y"":247,""width"":684,""height"":565}",{},565,rect,684,183,247,/home/dianwen/SIIM_ACR/train/images/1024/dicom/1.2.276.0.7230010.3.1.4.8323329.1235.1517875166.903964.png,/home/dianwen/SIIM_ACR/train/images/1024/mask/1.2.276.0.7230010.3.1.4.8323329.1235.1517875166.903964.png,0.0,0.0,812,867
1.2.276.0.7230010.3.1.4.8323329.1236.1517875166.906065.png,391196,{},1,0,"{""name"":""rect"",""x"":89,""y"":56,""width"":878,""height"":956}",{},956,rect,878,89,56,/home/dianwen/SIIM_ACR/train/images/1024/dicom/1.2.276.0.7230010.3.1.4.8323329.1236.1517875166.906065.png,/home/dianwen/SIIM_ACR/train/images/1024/mask/1.2.276.0.7230010.3.1.4.8323329.1236.1517875166.906065.png,0.0,0.0,1012,967
1.2.276.0.7230010.3.1.4.8323329.1237.1517875166.904962.png,345554,{},1,0,"{""name"":""rect"",""x"":58,""y"":135,""width"":863,""height"":882}",{},882,rect,863,58,135,/home/dianwen/SIIM_ACR/train/images/1024/dicom/1.2.276.0.7230010.3.1.4.8323329.1237.1517875166.904962.png,/home/dianwen/SIIM_ACR/train/images/1024/mask/1.2.276.0.7230010.3.1.4.8323329.1237.1517875166.904962.png,0.002951622009277344,1.0,1017,921
1.2.276.0.7230010.3.1.4.8323329.1238.1517875166.919970.png,340820,{},1,0,"{""name"":""rect"",""x"":31,""y"":21,""width"":871,""height"":871}",{},871,rect,871,31,21,/home/dianwen/SIIM_ACR/train/images/1024/dicom/1.2.276.0.7230010.3.1.4.8323329.1238.1517875166.919970.png,/home/dianwen/SIIM_ACR/train/images/1024/mask/1.2.276.0.7230010.3.1.4.8323329.1238.1517875166.919970.png,0.0,0.0,892,902
1.2.276.0.7230010.3.1.4.8323329.1240.1517875166.926914.png,417078,{},1,0,"{""name"":""rect"",""x"":164,""y"":130,""width"":797,""height"":631}",{},631,rect,797,164,130,/home/dianwen/SIIM_ACR/train/images/1024/dicom/1.2.276.0.7230010.3.1.4.8323329.1240.1517875166.926914.png,/home/dianwen/SIIM_ACR/train/images/1024/mask/1.2.276.0.7230010.3.1.4.8323329.1240.1517875166.926914.png,0.0,0.0,761,961
1.2.276.0.7230010.3.1.4.8323329.1241.1517875166.927802.png,432518,{},1,0,"{""name"":""rect"",""x"":117,""y"":57,""width"":787,""height"":795}",{},795,rect,787,117,57,/home/dianwen/SIIM_ACR/train/images/1024/dicom/1.2.276.0.7230010.3.1.4.8323329.1241.1517875166.927802.png,/home/dianwen/SIIM_ACR/train/images/1024/mask/1.2.276.0.7230010.3.1.4.8323329.1241.1517875166.927802.png,0.003090858459472656,1.0,852,904
1.2.276.0.7230010.3.1.4.8323329.1242.1517875166.948529.png,360410,{},1,0,"{""name"":""rect"",""x"":132,""y"":149,""width"":648,""height"":751}",{},751,rect,648,132,149,/home/dianwen/SIIM_ACR/train/images/1024/dicom/1.2.276.0.7230010.3.1.4.8323329.1242.1517875166.948529.png,/home/dianwen/SIIM_ACR/train/images/1024/mask/1.2.276.0.7230010.3.1.4.8323329.1242.1517875166.948529.png,0.0,0.0,900,780
1.2.276.0.7230010.3.1.4.8323329.1243.1517875166.938629.png,417583,{},1,0,"{""name"":""rect"",""x"":189,""y"":114,""width"":697,""height"":774}",{},774,rect,697,189,114,/home/dianwen/SIIM_ACR/train/images/1024/dicom/1.2.276.0.7230010.3.1.4.8323329.1243.1517875166.938629.png,/home/dianwen/SIIM_ACR/train/images/1024/mask/1.2.276.0.7230010.3.1.4.8323329.1243.1517875166.938629.png,0.0,0.0,888,886
1.2.276.0.7230010.3.1.4.8323329.1244.1517875166.954551.png,401772,{},1,0,"{""name"":""rect"",""x"":117,""y"":91,""width"":762,""height"":768}",{},768,rect,762,117,91,/home/dianwen/SIIM_ACR/train/images/1024/dicom/1.2.276.0.7230010.3.1.4.8323329.1244.1517875166.954551.png,/home/dianwen/SIIM_ACR/train/images/1024/mask/1.2.276.0.7230010.3.1.4.8323329.1244.1517875166.954551.png,0.0,0.0,859,879
1.2.276.0.7230010.3.1.4.8323329.1245.1517875166.958340.png,434687,{},1,0,"{""name"":""rect"",""x"":100,""y"":108,""width"":826,""height"":915}",{},915,rect,826,100,108,/home/dianwen/SIIM_ACR/train/images/1024/dicom/1.2.276.0.7230010.3.1.4.8323329.1245.1517875166.958340.png,/home/dianwen/SIIM_ACR/train/images/1024/mask/1.2.276.0.7230010.3.1.4.8323329.1245.1517875166.958340.png,0.04064083099365234,1.0,1023,926
1.2.276.0.7230010.3.1.4.8323329.1246.1517875166.960329.png,352828,{},1,0,"{""name"":""rect"",""x"":177,""y"":108,""width"":802,""height"":911}",{},911,rect,802,177,108,/home/dianwen/SIIM_ACR/train/images/1024/dicom/1.2.276.0.7230010.3.1.4.8323329.1246.1517875166.960329.png,/home/dianwen/SIIM_ACR/train/images/1024/mask/1.2.276.0.7230010.3.1.4.8323329.1246.1517875166.960329.png,0.03133869171142578,1.0,1019,979
1.2.276.0.7230010.3.1.4.8323329.1247.1517875166.953848.png,350491,{},1,0,"{""name"":""rect"",""x"":20,""y"":140,""width"":927,""height"":881}",{},881,rect,927,20,140,/home/dianwen/SIIM_ACR/train/images/1024/dicom/1.2.276.0.7230010.3.1.4.8323329.1247.1517875166.953848.png,/home/dianwen/SIIM_ACR/train/images/1024/mask/1.2.276.0.7230010.3.1.4.8323329.1247.1517875166.953848.png,0.0,0.0,1021,947
1.2.276.0.7230010.3.1.4.8323329.1248.1517875166.953780.png,391050,{},1,0,"{""name"":""rect"",""x"":26,""y"":91,""width"":897,""height"":927}",{},927,rect,897,26,91,/home/dianwen/SIIM_ACR/train/images/1024/dicom/1.2.276.0.7230010.3.1.4.8323329.1248.1517875166.953780.png,/home/dianwen/SIIM_ACR/train/images/1024/mask/1.2.276.0.7230010.3.1.4.8323329.1248.1517875166.953780.png,0.0,0.0,1018,923
1.2.276.0.7230010.3.1.4.8323329.1249.1517875166.967563.png,354017,{},1,0,"{""name"":""rect"",""x"":10,""y"":81,""width"":896,""height"":835}",{},835,rect,896,10,81,/home/dianwen/SIIM_ACR/train/images/1024/dicom/1.2.276.0.7230010.3.1.4.8323329.1249.1517875166.967563.png,/home/dianwen/SIIM_ACR/train/images/1024/mask/1.2.276.0.7230010.3.1.4.8323329.1249.1517875166.967563.png,0.0,0.0,916,906
1.2.276.0.7230010.3.1.4.8323329.1250.1517875166.960152.png,263879,{},1,0,"{""name"":""rect"",""x"":102,""y"":167,""width"":914,""height"":748}",{},748,rect,914,102,167,/home/dianwen/SIIM_ACR/train/images/1024/dicom/1.2.276.0.7230010.3.1.4.8323329.1250.1517875166.960152.png,/home/dianwen/SIIM_ACR/train/images/1024/mask/1.2.276.0.7230010.3.1.4.8323329.1250.1517875166.960152.png,0.0,0.0,915,1016
1.2.276.0.7230010.3.1.4.8323329.1251.1517875166.966302.png,420298,{},1,0,"{""name"":""rect"",""x"":123,""y"":78,""width"":790,""height"":914}",{},914,rect,790,123,78,/home/dianwen/SIIM_ACR/train/images/1024/dicom/1.2.276.0.7230010.3.1.4.8323329.1251.1517875166.966302.png,/home/dianwen/SIIM_ACR/train/images/1024/mask/1.2.276.0.7230010.3.1.4.8323329.1251.1517875166.966302.png,0.007855415344238281,1.0,992,913
1.2.276.0.7230010.3.1.4.8323329.1252.1517875166.979334.png,377231,{},1,0,"{""name"":""rect"",""x"":185,""y"":91,""width"":650,""height"":676}",{},676,rect,650,185,91,/home/dianwen/SIIM_ACR/train/images/1024/dicom/1.2.276.0.7230010.3.1.4.8323329.1252.1517875166.979334.png,/home/dianwen/SIIM_ACR/train/images/1024/mask/1.2.276.0.7230010.3.1.4.8323329.1252.1517875166.979334.png,0.006657600402832031,1.0,767,835
1.2.276.0.7230010.3.1.4.8323329.1253.1517875166.971849.png,330380,{},1,0,"{""name"":""rect"",""x"":211,""y"":104,""width"":628,""height"":827}",{},827,rect,628,211,104,/home/dianwen/SIIM_ACR/train/images/1024/dicom/1.2.276.0.7230010.3.1.4.8323329.1253.1517875166.971849.png,/home/dianwen/SIIM_ACR/train/images/1024/mask/1.2.276.0.7230010.3.1.4.8323329.1253.1517875166.971849.png,0.0,0.0,931,839
1.2.276.0.7230010.3.1.4.8323329.1254.1517875166.979277.png,398308,{},1,0,"{""name"":""rect"",""x"":36,""y"":128,""width"":905,""height"":733}",{},733,rect,905,36,128,/home/dianwen/SIIM_ACR/train/images/1024/dicom/1.2.276.0.7230010.3.1.4.8323329.1254.1517875166.979277.png,/home/dianwen/SIIM_ACR/train/images/1024/mask/1.2.276.0.7230010.3.1.4.8323329.1254.1517875166.979277.png,0.0,0.0,861,941
1.2.276.0.7230010.3.1.4.8323329.1255.1517875166.987070.png,431374,{},1,0,"{""name"":""rect"",""x"":105,""y"":93,""width"":767,""height"":836}",{},836,rect,767,105,93,/home/dianwen/SIIM_ACR/train/images/1024/dicom/1.2.276.0.7230010.3.1.4.8323329.1255.1517875166.987070.png,/home/dianwen/SIIM_ACR/train/images/1024/mask/1.2.276.0.7230010.3.1.4.8323329.1255.1517875166.987070.png,0.01819419860839844,1.0,929,872
1.2.276.0.7230010.3.1.4.8323329.1256.1517875166.994023.png,376922,{},1,0,"{""name"":""rect"",""x"":133,""y"":34,""width"":870,""height"":907}",{},907,rect,870,133,34,/home/dianwen/SIIM_ACR/train/images/1024/dicom/1.2.276.0.7230010.3.1.4.8323329.1256.1517875166.994023.png,/home/dianwen/SIIM_ACR/train/images/1024/mask/1.2.276.0.7230010.3.1.4.8323329.1256.1517875166.994023.png,0.0,0.0,941,1003
1.2.276.0.7230010.3.1.4.8323329.1257.1517875166.994874.png,348882,{},1,0,"{""name"":""rect"",""x"":158,""y"":14,""width"":805,""height"":908}",{},908,rect,805,158,14,/home/dianwen/SIIM_ACR/train/images/1024/dicom/1.2.276.0.7230010.3.1.4.8323329.1257.1517875166.994874.png,/home/dianwen/SIIM_ACR/train/images/1024/mask/1.2.276.0.7230010.3.1.4.8323329.1257.1517875166.994874.png,0.0,0.0,922,963
1.2.276.0.7230010.3.1.4.8323329.1258.1517875166.987375.png,352214,{},1,0,"{""name"":""rect"",""x"":114,""y"":83,""width"":796,""height"":937}",{},937,rect,796,114,83,/home/dianwen/SIIM_ACR/train/images/1024/dicom/1.2.276.0.7230010.3.1.4.8323329.1258.1517875166.987375.png,/home/dianwen/SIIM_ACR/train/images/1024/mask/1.2.276.0.7230010.3.1.4.8323329.1258.1517875166.987375.png,0.0,0.0,1020,910
1.2.276.0.7230010.3.1.4.8323329.1259.1517875167.3922.png,408584,{},1,0,"{""name"":""rect"",""x"":193,""y"":164,""width"":680,""height"":666}",{},666,rect,680,193,164,/home/dianwen/SIIM_ACR/train/images/1024/dicom/1.2.276.0.7230010.3.1.4.8323329.1259.1517875167.3922.png,/home/dianwen/SIIM_ACR/train/images/1024/mask/1.2.276.0.7230010.3.1.4.8323329.1259.1517875167.3922.png,0.0036821365356445312,1.0,830,873
1.2.276.0.7230010.3.1.4.8323329.1260.1517875167.4831.png,354994,{},1,0,"{""name"":""rect"",""x"":126,""y"":84,""width"":747,""height"":711}",{},711,rect,747,126,84,/home/dianwen/SIIM_ACR/train/images/1024/dicom/1.2.276.0.7230010.3.1.4.8323329.1260.1517875167.4831.png,/home/dianwen/SIIM_ACR/train/images/1024/mask/1.2.276.0.7230010.3.1.4.8323329.1260.1517875167.4831.png,0.0,0.0,795,873
1.2.276.0.7230010.3.1.4.8323329.1261.1517875167.10791.png,373660,{},1,0,"{""name"":""rect"",""x"":99,""y"":47,""width"":846,""height"":935}",{},935,rect,846,99,47,/home/dianwen/SIIM_ACR/train/images/1024/dicom/1.2.276.0.7230010.3.1.4.8323329.1261.1517875167.10791.png,/home/dianwen/SIIM_ACR/train/images/1024/mask/1.2.276.0.7230010.3.1.4.8323329.1261.1517875167.10791.png,0.0,0.0,982,945
1.2.276.0.7230010.3.1.4.8323329.1262.1517875167.11459.png,398234,{},1,0,"{""name"":""rect"",""x"":126,""y"":61,""width"":716,""height"":687}",{},687,rect,716,126,61,/home/dianwen/SIIM_ACR/train/images/1024/dicom/1.2.276.0.7230010.3.1.4.8323329.1262.1517875167.11459.png,/home/dianwen/SIIM_ACR/train/images/1024/mask/1.2.276.0.7230010.3.1.4.8323329.1262.1517875167.11459.png,0.0,0.0,748,842
1.2.276.0.7230010.3.1.4.8323329.1263.1517875167.19062.png,394428,{},1,0,"{""name"":""rect"",""x"":171,""y"":66,""width"":693,""height"":823}",{},823,rect,693,171,66,/home/dianwen/SIIM_ACR/train/images/1024/dicom/1.2.276.0.7230010.3.1.4.8323329.1263.1517875167.19062.png,/home/dianwen/SIIM_ACR/train/images/1024/mask/1.2.276.0.7230010.3.1.4.8323329.1263.1517875167.19062.png,0.02875518798828125,1.0,889,864
1.2.276.0.7230010.3.1.4.8323329.1264.1517875167.17680.png,340930,{},1,0,"{""name"":""rect"",""x"":154,""y"":149,""width"":807,""height"":853}",{},853,rect,807,154,149,/home/dianwen/SIIM_ACR/train/images/1024/dicom/1.2.276.0.7230010.3.1.4.8323329.1264.1517875167.17680.png,/home/dianwen/SIIM_ACR/train/images/1024/mask/1.2.276.0.7230010.3.1.4.8323329.1264.1517875167.17680.png,0.0,0.0,1002,961
1.2.276.0.7230010.3.1.4.8323329.1265.1517875167.28712.png,371188,{},1,0,"{""name"":""rect"",""x"":163,""y"":98,""width"":756,""height"":783}",{},783,rect,756,163,98,/home/dianwen/SIIM_ACR/train/images/1024/dicom/1.2.276.0.7230010.3.1.4.8323329.1265.1517875167.28712.png,/home/dianwen/SIIM_ACR/train/images/1024/mask/1.2.276.0.7230010.3.1.4.8323329.1265.1517875167.28712.png,0.0,0.0,881,919
1.2.276.0.7230010.3.1.4.8323329.1266.1517875167.42726.png,345243,{},1,0,"{""name"":""rect"",""x"":133,""y"":16,""width"":802,""height"":683}",{},683,rect,802,133,16,/home/dianwen/SIIM_ACR/train/images/1024/dicom/1.2.276.0.7230010.3.1.4.8323329.1266.1517875167.42726.png,/home/dianwen/SIIM_ACR/train/images/1024/mask/1.2.276.0.7230010.3.1.4.8323329.1266.1517875167.42726.png,0.0,0.0,699,935
1.2.276.0.7230010.3.1.4.8323329.1267.1517875167.42813.png,422593,{},1,0,"{""name"":""rect"",""x"":181,""y"":5,""width"":761,""height"":714}",{},714,rect,761,181,5,/home/dianwen/SIIM_ACR/train/images/1024/dicom/1.2.276.0.7230010.3.1.4.8323329.1267.1517875167.42813.png,/home/dianwen/SIIM_ACR/train/images/1024/mask/1.2.276.0.7230010.3.1.4.8323329.1267.1517875167.42813.png,0.0,0.0,719,942
1.2.276.0.7230010.3.1.4.8323329.1268.1517875167.47034.png,395247,{},1,0,"{""name"":""rect"",""x"":57,""y"":120,""width"":926,""height"":886}",{},886,rect,926,57,120,/home/dianwen/SIIM_ACR/train/images/1024/dicom/1.2.276.0.7230010.3.1.4.8323329.1268.1517875167.47034.png,/home/dianwen/SIIM_ACR/train/images/1024/mask/1.2.276.0.7230010.3.1.4.8323329.1268.1517875167.47034.png,0.0,0.0,1006,983
1.2.276.0.7230010.3.1.4.8323329.1269.1517875167.52184.png,419256,{},1,0,"{""name"":""rect"",""x"":93,""y"":7,""width"":804,""height"":1017}",{},1017,rect,804,93,7,/home/dianwen/SIIM_ACR/train/images/1024/dicom/1.2.276.0.7230010.3.1.4.8323329.1269.1517875167.52184.png,/home/dianwen/SIIM_ACR/train/images/1024/mask/1.2.276.0.7230010.3.1.4.8323329.1269.1517875167.52184.png,0.0,0.0,1024,897
1.2.276.0.7230010.3.1.4.8323329.1270.1517875167.56644.png,410541,{},1,0,"{""name"":""rect"",""x"":176,""y"":72,""width"":684,""height"":854}",{},854,rect,684,176,72,/home/dianwen/SIIM_ACR/train/images/1024/dicom/1.2.276.0.7230010.3.1.4.8323329.1270.1517875167.56644.png,/home/dianwen/SIIM_ACR/train/images/1024/mask/1.2.276.0.7230010.3.1.4.8323329.1270.1517875167.56644.png,0.0,0.0,926,860
1.2.276.0.7230010.3.1.4.8323329.1271.1517875167.67991.png,419553,{},1,0,"{""name"":""rect"",""x"":59,""y"":143,""width"":911,""height"":716}",{},716,rect,911,59,143,/home/dianwen/SIIM_ACR/train/images/1024/dicom/1.2.276.0.7230010.3.1.4.8323329.1271.1517875167.67991.png,/home/dianwen/SIIM_ACR/train/images/1024/mask/1.2.276.0.7230010.3.1.4.8323329.1271.1517875167.67991.png,0.0,0.0,859,970
1.2.276.0.7230010.3.1.4.8323329.1272.1517875167.67528.png,348989,{},1,0,"{""name"":""rect"",""x"":141,""y"":83,""width"":747,""height"":743}",{},743,rect,747,141,83,/home/dianwen/SIIM_ACR/train/images/1024/dicom/1.2.276.0.7230010.3.1.4.8323329.1272.1517875167.67528.png,/home/dianwen/SIIM_ACR/train/images/1024/mask/1.2.276.0.7230010.3.1.4.8323329.1272.1517875167.67528.png,0.0,0.0,826,888
1.2.276.0.7230010.3.1.4.8323329.1273.1517875167.68057.png,410957,{},1,0,"{""name"":""rect"",""x"":77,""y"":38,""width"":836,""height"":877}",{},877,rect,836,77,38,/home/dianwen/SIIM_ACR/train/images/1024/dicom/1.2.276.0.7230010.3.1.4.8323329.1273.1517875167.68057.png,/home/dianwen/SIIM_ACR/train/images/1024/mask/1.2.276.0.7230010.3.1.4.8323329.1273.1517875167.68057.png,0.0,0.0,915,913
1.2.276.0.7230010.3.1.4.8323329.1274.1517875167.73899.png,372623,{},1,0,"{""name"":""rect"",""x"":69,""y"":122,""width"":769,""height"":890}",{},890,rect,769,69,122,/home/dianwen/SIIM_ACR/train/images/1024/dicom/1.2.276.0.7230010.3.1.4.8323329.1274.1517875167.73899.png,/home/dianwen/SIIM_ACR/train/images/1024/mask/1.2.276.0.7230010.3.1.4.8323329.1274.1517875167.73899.png,0.0,0.0,1012,838
1.2.276.0.7230010.3.1.4.8323329.1275.1517875167.76823.png,368503,{},1,0,"{""name"":""rect"",""x"":108,""y"":114,""width"":723,""height"":847}",{},847,rect,723,108,114,/home/dianwen/SIIM_ACR/train/images/1024/dicom/1.2.276.0.7230010.3.1.4.8323329.1275.1517875167.76823.png,/home/dianwen/SIIM_ACR/train/images/1024/mask/1.2.276.0.7230010.3.1.4.8323329.1275.1517875167.76823.png,0.0,0.0,961,831
1.2.276.0.7230010.3.1.4.8323329.1277.1517875167.81950.png,444969,{},1,0,"{""name"":""rect"",""x"":157,""y"":108,""width"":813,""height"":772}",{},772,rect,813,157,108,/home/dianwen/SIIM_ACR/train/images/1024/dicom/1.2.276.0.7230010.3.1.4.8323329.1277.1517875167.81950.png,/home/dianwen/SIIM_ACR/train/images/1024/mask/1.2.276.0.7230010.3.1.4.8323329.1277.1517875167.81950.png,0.0010671615600585938,1.0,880,970
1.2.276.0.7230010.3.1.4.8323329.1278.1517875167.92617.png,367612,{},1,0,"{""name"":""rect"",""x"":68,""y"":81,""width"":846,""height"":938}",{},938,rect,846,68,81,/home/dianwen/SIIM_ACR/train/images/1024/dicom/1.2.276.0.7230010.3.1.4.8323329.1278.1517875167.92617.png,/home/dianwen/SIIM_ACR/train/images/1024/mask/1.2.276.0.7230010.3.1.4.8323329.1278.1517875167.92617.png,0.0,0.0,1019,914
1.2.276.0.7230010.3.1.4.8323329.1279.1517875167.105385.png,423183,{},1,0,"{""name"":""rect"",""x"":75,""y"":87,""width"":830,""height"":725}",{},725,rect,830,75,87,/home/dianwen/SIIM_ACR/train/images/1024/dicom/1.2.276.0.7230010.3.1.4.8323329.1279.1517875167.105385.png,/home/dianwen/SIIM_ACR/train/images/1024/mask/1.2.276.0.7230010.3.1.4.8323329.1279.1517875167.105385.png,0.0,0.0,812,905
1.2.276.0.7230010.3.1.4.8323329.1280.1517875167.98621.png,352820,{},1,0,"{""name"":""rect"",""x"":105,""y"":41,""width"":846,""height"":980}",{},980,rect,846,105,41,/home/dianwen/SIIM_ACR/train/images/1024/dicom/1.2.276.0.7230010.3.1.4.8323329.1280.1517875167.98621.png,/home/dianwen/SIIM_ACR/train/images/1024/mask/1.2.276.0.7230010.3.1.4.8323329.1280.1517875167.98621.png,0.0,0.0,1021,951
1.2.276.0.7230010.3.1.4.8323329.1281.1517875167.103069.png,393752,{},1,0,"{""name"":""rect"",""x"":81,""y"":164,""width"":780,""height"":614}",{},614,rect,780,81,164,/home/dianwen/SIIM_ACR/train/images/1024/dicom/1.2.276.0.7230010.3.1.4.8323329.1281.1517875167.103069.png,/home/dianwen/SIIM_ACR/train/images/1024/mask/1.2.276.0.7230010.3.1.4.8323329.1281.1517875167.103069.png,0.0,0.0,778,861
1.2.276.0.7230010.3.1.4.8323329.1282.1517875167.114379.png,378557,{},1,0,"{""name"":""rect"",""x"":96,""y"":28,""width"":788,""height"":817}",{},817,rect,788,96,28,/home/dianwen/SIIM_ACR/train/images/1024/dicom/1.2.276.0.7230010.3.1.4.8323329.1282.1517875167.114379.png,/home/dianwen/SIIM_ACR/train/images/1024/mask/1.2.276.0.7230010.3.1.4.8323329.1282.1517875167.114379.png,0.0,0.0,845,884
1.2.276.0.7230010.3.1.4.8323329.1284.1517875167.122271.png,317098,{},1,0,"{""name"":""rect"",""x"":127,""y"":125,""width"":873,""height"":875}",{},875,rect,873,127,125,/home/dianwen/SIIM_ACR/train/images/1024/dicom/1.2.276.0.7230010.3.1.4.8323329.1284.1517875167.122271.png,/home/dianwen/SIIM_ACR/train/images/1024/mask/1.2.276.0.7230010.3.1.4.8323329.1284.1517875167.122271.png,0.0,0.0,1000,1000
1.2.276.0.7230010.3.1.4.8323329.1285.1517875167.137313.png,345356,{},1,0,"{""name"":""rect"",""x"":178,""y"":157,""width"":723,""height"":770}",{},770,rect,723,178,157,/home/dianwen/SIIM_ACR/train/images/1024/dicom/1.2.276.0.7230010.3.1.4.8323329.1285.1517875167.137313.png,/home/dianwen/SIIM_ACR/train/images/1024/mask/1.2.276.0.7230010.3.1.4.8323329.1285.1517875167.137313.png,0.0,0.0,927,901
1.2.276.0.7230010.3.1.4.8323329.1286.1517875167.138303.png,413338,{},1,0,"{""name"":""rect"",""x"":143,""y"":129,""width"":800,""height"":713}",{},713,rect,800,143,129,/home/dianwen/SIIM_ACR/train/images/1024/dicom/1.2.276.0.7230010.3.1.4.8323329.1286.1517875167.138303.png,/home/dianwen/SIIM_ACR/train/images/1024/mask/1.2.276.0.7230010.3.1.4.8323329.1286.1517875167.138303.png,0.0,0.0,842,943
1.2.276.0.7230010.3.1.4.8323329.1287.1517875167.127725.png,336519,{},1,0,"{""name"":""rect"",""x"":114,""y"":68,""width"":897,""height"":919}",{},919,rect,897,114,68,/home/dianwen/SIIM_ACR/train/images/1024/dicom/1.2.276.0.7230010.3.1.4.8323329.1287.1517875167.127725.png,/home/dianwen/SIIM_ACR/train/images/1024/mask/1.2.276.0.7230010.3.1.4.8323329.1287.1517875167.127725.png,0.0,0.0,987,1011
1.2.276.0.7230010.3.1.4.8323329.1288.1517875167.131713.png,367757,{},1,0,"{""name"":""rect"",""x"":62,""y"":111,""width"":820,""height"":913}",{},913,rect,820,62,111,/home/dianwen/SIIM_ACR/train/images/1024/dicom/1.2.276.0.7230010.3.1.4.8323329.1288.1517875167.131713.png,/home/dianwen/SIIM_ACR/train/images/1024/mask/1.2.276.0.7230010.3.1.4.8323329.1288.1517875167.131713.png,0.0,0.0,1024,882
1.2.276.0.7230010.3.1.4.8323329.1289.1517875167.149899.png,412742,{},1,0,"{""name"":""rect"",""x"":184,""y"":145,""width"":789,""height"":733}",{},733,rect,789,184,145,/home/dianwen/SIIM_ACR/train/images/1024/dicom/1.2.276.0.7230010.3.1.4.8323329.1289.1517875167.149899.png,/home/dianwen/SIIM_ACR/train/images/1024/mask/1.2.276.0.7230010.3.1.4.8323329.1289.1517875167.149899.png,0.016607284545898438,1.0,878,973
1.2.276.0.7230010.3.1.4.8323329.1290.1517875167.145267.png,331409,{},1,0,"{""name"":""rect"",""x"":18,""y"":123,""width"":819,""height"":899}",{},899,rect,819,18,123,/home/dianwen/SIIM_ACR/train/images/1024/dicom/1.2.276.0.7230010.3.1.4.8323329.1290.1517875167.145267.png,/home/dianwen/SIIM_ACR/train/images/1024/mask/1.2.276.0.7230010.3.1.4.8323329.1290.1517875167.145267.png,0.0,0.0,1022,837
1.2.276.0.7230010.3.1.4.8323329.1291.1517875167.149747.png,348623,{},1,0,"{""name"":""rect"",""x"":111,""y"":225,""width"":655,""height"":625}",{},625,rect,655,111,225,/home/dianwen/SIIM_ACR/train/images/1024/dicom/1.2.276.0.7230010.3.1.4.8323329.1291.1517875167.149747.png,/home/dianwen/SIIM_ACR/train/images/1024/mask/1.2.276.0.7230010.3.1.4.8323329.1291.1517875167.149747.png,0.0,0.0,850,766
1.2.276.0.7230010.3.1.4.8323329.1292.1517875167.157306.png,325085,{},1,0,"{""name"":""rect"",""x"":186,""y"":40,""width"":692,""height"":741}",{},741,rect,692,186,40,/home/dianwen/SIIM_ACR/train/images/1024/dicom/1.2.276.0.7230010.3.1.4.8323329.1292.1517875167.157306.png,/home/dianwen/SIIM_ACR/train/images/1024/mask/1.2.276.0.7230010.3.1.4.8323329.1292.1517875167.157306.png,0.0,0.0,781,878
1.2.276.0.7230010.3.1.4.8323329.1293.1517875167.154346.png,426805,{},1,0,"{""name"":""rect"",""x"":138,""y"":105,""width"":826,""height"":916}",{},916,rect,826,138,105,/home/dianwen/SIIM_ACR/train/images/1024/dicom/1.2.276.0.7230010.3.1.4.8323329.1293.1517875167.154346.png,/home/dianwen/SIIM_ACR/train/images/1024/mask/1.2.276.0.7230010.3.1.4.8323329.1293.1517875167.154346.png,0.0,0.0,1021,964
1.2.276.0.7230010.3.1.4.8323329.1294.1517875167.167706.png,413158,{},1,0,"{""name"":""rect"",""x"":184,""y"":180,""width"":746,""height"":842}",{},842,rect,746,184,180,/home/dianwen/SIIM_ACR/train/images/1024/dicom/1.2.276.0.7230010.3.1.4.8323329.1294.1517875167.167706.png,/home/dianwen/SIIM_ACR/train/images/1024/mask/1.2.276.0.7230010.3.1.4.8323329.1294.1517875167.167706.png,0.0,0.0,1022,930
1.2.276.0.7230010.3.1.4.8323329.1296.1517875167.165230.png,236060,{},1,0,"{""name"":""rect"",""x"":130,""y"":211,""width"":658,""height"":512}",{},512,rect,658,130,211,/home/dianwen/SIIM_ACR/train/images/1024/dicom/1.2.276.0.7230010.3.1.4.8323329.1296.1517875167.165230.png,/home/dianwen/SIIM_ACR/train/images/1024/mask/1.2.276.0.7230010.3.1.4.8323329.1296.1517875167.165230.png,0.0,0.0,723,788
1.2.276.0.7230010.3.1.4.8323329.1297.1517875167.179005.png,435979,{},1,0,"{""name"":""rect"",""x"":83,""y"":55,""width"":792,""height"":830}",{},830,rect,792,83,55,/home/dianwen/SIIM_ACR/train/images/1024/dicom/1.2.276.0.7230010.3.1.4.8323329.1297.1517875167.179005.png,/home/dianwen/SIIM_ACR/train/images/1024/mask/1.2.276.0.7230010.3.1.4.8323329.1297.1517875167.179005.png,0.0,0.0,885,875
1.2.276.0.7230010.3.1.4.8323329.1298.1517875167.175478.png,430771,{},1,0,"{""name"":""rect"",""x"":115,""y"":86,""width"":856,""height"":722}",{},722,rect,856,115,86,/home/dianwen/SIIM_ACR/train/images/1024/dicom/1.2.276.0.7230010.3.1.4.8323329.1298.1517875167.175478.png,/home/dianwen/SIIM_ACR/train/images/1024/mask/1.2.276.0.7230010.3.1.4.8323329.1298.1517875167.175478.png,0.0,0.0,808,971
1.2.276.0.7230010.3.1.4.8323329.1299.1517875167.176879.png,384278,{},1,0,"{""name"":""rect"",""x"":58,""y"":57,""width"":908,""height"":877}",{},877,rect,908,58,57,/home/dianwen/SIIM_ACR/train/images/1024/dicom/1.2.276.0.7230010.3.1.4.8323329.1299.1517875167.176879.png,/home/dianwen/SIIM_ACR/train/images/1024/mask/1.2.276.0.7230010.3.1.4.8323329.1299.1517875167.176879.png,0.0,0.0,934,966
1.2.276.0.7230010.3.1.4.8323329.1300.1517875167.172832.png,202162,{},1,0,"{""name"":""rect"",""x"":223,""y"":111,""width"":512,""height"":472}",{},472,rect,512,223,111,/home/dianwen/SIIM_ACR/train/images/1024/dicom/1.2.276.0.7230010.3.1.4.8323329.1300.1517875167.172832.png,/home/dianwen/SIIM_ACR/train/images/1024/mask/1.2.276.0.7230010.3.1.4.8323329.1300.1517875167.172832.png,0.0,0.0,583,735
1.2.276.0.7230010.3.1.4.8323329.1301.1517875167.171925.png,369937,{},1,0,"{""name"":""rect"",""x"":94,""y"":82,""width"":811,""height"":940}",{},940,rect,811,94,82,/home/dianwen/SIIM_ACR/train/images/1024/dicom/1.2.276.0.7230010.3.1.4.8323329.1301.1517875167.171925.png,/home/dianwen/SIIM_ACR/train/images/1024/mask/1.2.276.0.7230010.3.1.4.8323329.1301.1517875167.171925.png,0.0,0.0,1022,905
1.2.276.0.7230010.3.1.4.8323329.1302.1517875167.175613.png,336422,{},1,0,"{""name"":""rect"",""x"":289,""y"":215,""width"":706,""height"":796}",{},796,rect,706,289,215,/home/dianwen/SIIM_ACR/train/images/1024/dicom/1.2.276.0.7230010.3.1.4.8323329.1302.1517875167.175613.png,/home/dianwen/SIIM_ACR/train/images/1024/mask/1.2.276.0.7230010.3.1.4.8323329.1302.1517875167.175613.png,0.0,0.0,1011,995
1.2.276.0.7230010.3.1.4.8323329.1303.1517875167.181459.png,414899,{},1,0,"{""name"":""rect"",""x"":152,""y"":139,""width"":758,""height"":759}",{},759,rect,758,152,139,/home/dianwen/SIIM_ACR/train/images/1024/dicom/1.2.276.0.7230010.3.1.4.8323329.1303.1517875167.181459.png,/home/dianwen/SIIM_ACR/train/images/1024/mask/1.2.276.0.7230010.3.1.4.8323329.1303.1517875167.181459.png,0.0,0.0,898,910
1.2.276.0.7230010.3.1.4.8323329.1304.1517875167.193152.png,359845,{},1,0,"{""name"":""rect"",""x"":94,""y"":179,""width"":830,""height"":703}",{},703,rect,830,94,179,/home/dianwen/SIIM_ACR/train/images/1024/dicom/1.2.276.0.7230010.3.1.4.8323329.1304.1517875167.193152.png,/home/dianwen/SIIM_ACR/train/images/1024/mask/1.2.276.0.7230010.3.1.4.8323329.1304.1517875167.193152.png,0.0042572021484375,1.0,882,924
1.2.276.0.7230010.3.1.4.8323329.1305.1517875167.199800.png,350805,{},1,0,"{""name"":""rect"",""x"":136,""y"":122,""width"":762,""height"":901}",{},901,rect,762,136,122,/home/dianwen/SIIM_ACR/train/images/1024/dicom/1.2.276.0.7230010.3.1.4.8323329.1305.1517875167.199800.png,/home/dianwen/SIIM_ACR/train/images/1024/mask/1.2.276.0.7230010.3.1.4.8323329.1305.1517875167.199800.png,0.0,0.0,1023,898
1.2.276.0.7230010.3.1.4.8323329.1306.1517875167.203675.png,424807,{},1,0,"{""name"":""rect"",""x"":174,""y"":58,""width"":726,""height"":745}",{},745,rect,726,174,58,/home/dianwen/SIIM_ACR/train/images/1024/dicom/1.2.276.0.7230010.3.1.4.8323329.1306.1517875167.203675.png,/home/dianwen/SIIM_ACR/train/images/1024/mask/1.2.276.0.7230010.3.1.4.8323329.1306.1517875167.203675.png,0.023336410522460938,1.0,803,900
1.2.276.0.7230010.3.1.4.8323329.1307.1517875167.209265.png,459969,{},1,0,"{""name"":""rect"",""x"":33,""y"":63,""width"":953,""height"":958}",{},958,rect,953,33,63,/home/dianwen/SIIM_ACR/train/images/1024/dicom/1.2.276.0.7230010.3.1.4.8323329.1307.1517875167.209265.png,/home/dianwen/SIIM_ACR/train/images/1024/mask/1.2.276.0.7230010.3.1.4.8323329.1307.1517875167.209265.png,0.005702018737792969,1.0,1021,986
1.2.276.0.7230010.3.1.4.8323329.1308.1517875167.201116.png,426257,{},1,0,"{""name"":""rect"",""x"":95,""y"":95,""width"":838,""height"":775}",{},775,rect,838,95,95,/home/dianwen/SIIM_ACR/train/images/1024/dicom/1.2.276.0.7230010.3.1.4.8323329.1308.1517875167.201116.png,/home/dianwen/SIIM_ACR/train/images/1024/mask/1.2.276.0.7230010.3.1.4.8323329.1308.1517875167.201116.png,0.0,0.0,870,933
1.2.276.0.7230010.3.1.4.8323329.1309.1517875167.210689.png,463817,{},1,0,"{""name"":""rect"",""x"":43,""y"":126,""width"":950,""height"":896}",{},896,rect,950,43,126,/home/dianwen/SIIM_ACR/train/images/1024/dicom/1.2.276.0.7230010.3.1.4.8323329.1309.1517875167.210689.png,/home/dianwen/SIIM_ACR/train/images/1024/mask/1.2.276.0.7230010.3.1.4.8323329.1309.1517875167.210689.png,0.0,0.0,1022,993
1.2.276.0.7230010.3.1.4.8323329.1310.1517875167.208354.png,377964,{},1,0,"{""name"":""rect"",""x"":156,""y"":133,""width"":795,""height"":871}",{},871,rect,795,156,133,/home/dianwen/SIIM_ACR/train/images/1024/dicom/1.2.276.0.7230010.3.1.4.8323329.1310.1517875167.208354.png,/home/dianwen/SIIM_ACR/train/images/1024/mask/1.2.276.0.7230010.3.1.4.8323329.1310.1517875167.208354.png,0.0,0.0,1004,951
1.2.276.0.7230010.3.1.4.8323329.1311.1517875167.214817.png,330740,{},1,0,"{""name"":""rect"",""x"":205,""y"":129,""width"":684,""height"":712}",{},712,rect,684,205,129,/home/dianwen/SIIM_ACR/train/images/1024/dicom/1.2.276.0.7230010.3.1.4.8323329.1311.1517875167.214817.png,/home/dianwen/SIIM_ACR/train/images/1024/mask/1.2.276.0.7230010.3.1.4.8323329.1311.1517875167.214817.png,0.01742076873779297,1.0,841,889
1.2.276.0.7230010.3.1.4.8323329.1312.1517875167.216527.png,441145,{},1,0,"{""name"":""rect"",""x"":130,""y"":84,""width"":821,""height"":777}",{},777,rect,821,130,84,/home/dianwen/SIIM_ACR/train/images/1024/dicom/1.2.276.0.7230010.3.1.4.8323329.1312.1517875167.216527.png,/home/dianwen/SIIM_ACR/train/images/1024/mask/1.2.276.0.7230010.3.1.4.8323329.1312.1517875167.216527.png,0.0,0.0,861,951
1.2.276.0.7230010.3.1.4.8323329.1313.1517875167.218452.png,347688,{},1,0,"{""name"":""rect"",""x"":140,""y"":140,""width"":751,""height"":797}",{},797,rect,751,140,140,/home/dianwen/SIIM_ACR/train/images/1024/dicom/1.2.276.0.7230010.3.1.4.8323329.1313.1517875167.218452.png,/home/dianwen/SIIM_ACR/train/images/1024/mask/1.2.276.0.7230010.3.1.4.8323329.1313.1517875167.218452.png,0.0,0.0,937,891
1.2.276.0.7230010.3.1.4.8323329.1314.1517875167.222290.png,416101,{},1,0,"{""name"":""rect"",""x"":96,""y"":76,""width"":836,""height"":836}",{},836,rect,836,96,76,/home/dianwen/SIIM_ACR/train/images/1024/dicom/1.2.276.0.7230010.3.1.4.8323329.1314.1517875167.222290.png,/home/dianwen/SIIM_ACR/train/images/1024/mask/1.2.276.0.7230010.3.1.4.8323329.1314.1517875167.222290.png,0.027731895446777344,1.0,912,932
1.2.276.0.7230010.3.1.4.8323329.1315.1517875167.219653.png,425891,{},1,0,"{""name"":""rect"",""x"":116,""y"":84,""width"":829,""height"":817}",{},817,rect,829,116,84,/home/dianwen/SIIM_ACR/train/images/1024/dicom/1.2.276.0.7230010.3.1.4.8323329.1315.1517875167.219653.png,/home/dianwen/SIIM_ACR/train/images/1024/mask/1.2.276.0.7230010.3.1.4.8323329.1315.1517875167.219653.png,0.0,0.0,901,945
1.2.276.0.7230010.3.1.4.8323329.1316.1517875167.222425.png,410333,{},1,0,"{""name"":""rect"",""x"":99,""y"":61,""width"":800,""height"":762}",{},762,rect,800,99,61,/home/dianwen/SIIM_ACR/train/images/1024/dicom/1.2.276.0.7230010.3.1.4.8323329.1316.1517875167.222425.png,/home/dianwen/SIIM_ACR/train/images/1024/mask/1.2.276.0.7230010.3.1.4.8323329.1316.1517875167.222425.png,0.0,0.0,823,899
1.2.276.0.7230010.3.1.4.8323329.1317.1517875167.224344.png,403128,{},1,0,"{""name"":""rect"",""x"":105,""y"":120,""width"":828,""height"":829}",{},829,rect,828,105,120,/home/dianwen/SIIM_ACR/train/images/1024/dicom/1.2.276.0.7230010.3.1.4.8323329.1317.1517875167.224344.png,/home/dianwen/SIIM_ACR/train/images/1024/mask/1.2.276.0.7230010.3.1.4.8323329.1317.1517875167.224344.png,0.01836585998535156,1.0,949,933
1.2.276.0.7230010.3.1.4.8323329.1318.1517875167.235998.png,346289,{},1,0,"{""name"":""rect"",""x"":33,""y"":48,""width"":830,""height"":782}",{},782,rect,830,33,48,/home/dianwen/SIIM_ACR/train/images/1024/dicom/1.2.276.0.7230010.3.1.4.8323329.1318.1517875167.235998.png,/home/dianwen/SIIM_ACR/train/images/1024/mask/1.2.276.0.7230010.3.1.4.8323329.1318.1517875167.235998.png,0.0,0.0,830,863
1.2.276.0.7230010.3.1.4.8323329.1320.1517875167.236100.png,461232,{},1,0,"{""name"":""rect"",""x"":44,""y"":112,""width"":852,""height"":778}",{},778,rect,852,44,112,/home/dianwen/SIIM_ACR/train/images/1024/dicom/1.2.276.0.7230010.3.1.4.8323329.1320.1517875167.236100.png,/home/dianwen/SIIM_ACR/train/images/1024/mask/1.2.276.0.7230010.3.1.4.8323329.1320.1517875167.236100.png,0.05294322967529297,1.0,890,896
1.2.276.0.7230010.3.1.4.8323329.1323.1517875167.247380.png,332231,{},1,0,"{""name"":""rect"",""x"":95,""y"":154,""width"":765,""height"":838}",{},838,rect,765,95,154,/home/dianwen/SIIM_ACR/train/images/1024/dicom/1.2.276.0.7230010.3.1.4.8323329.1323.1517875167.247380.png,/home/dianwen/SIIM_ACR/train/images/1024/mask/1.2.276.0.7230010.3.1.4.8323329.1323.1517875167.247380.png,0.0,0.0,992,860
1.2.276.0.7230010.3.1.4.8323329.1324.1517875167.245620.png,448032,{},1,0,"{""name"":""rect"",""x"":87,""y"":53,""width"":825,""height"":807}",{},807,rect,825,87,53,/home/dianwen/SIIM_ACR/train/images/1024/dicom/1.2.276.0.7230010.3.1.4.8323329.1324.1517875167.245620.png,/home/dianwen/SIIM_ACR/train/images/1024/mask/1.2.276.0.7230010.3.1.4.8323329.1324.1517875167.245620.png,0.0,0.0,860,912
1.2.276.0.7230010.3.1.4.8323329.1325.1517875167.247733.png,420096,{},1,0,"{""name"":""rect"",""x"":102,""y"":103,""width"":790,""height"":838}",{},838,rect,790,102,103,/home/dianwen/SIIM_ACR/train/images/1024/dicom/1.2.276.0.7230010.3.1.4.8323329.1325.1517875167.247733.png,/home/dianwen/SIIM_ACR/train/images/1024/mask/1.2.276.0.7230010.3.1.4.8323329.1325.1517875167.247733.png,0.0,0.0,941,892
1.2.276.0.7230010.3.1.4.8323329.1326.1517875167.247930.png,349063,{},1,0,"{""name"":""rect"",""x"":337,""y"":313,""width"":680,""height"":638}",{},638,rect,680,337,313,/home/dianwen/SIIM_ACR/train/images/1024/dicom/1.2.276.0.7230010.3.1.4.8323329.1326.1517875167.247930.png,/home/dianwen/SIIM_ACR/train/images/1024/mask/1.2.276.0.7230010.3.1.4.8323329.1326.1517875167.247930.png,0.0,0.0,951,1017
1.2.276.0.7230010.3.1.4.8323329.1327.1517875167.260042.png,353214,{},1,0,"{""name"":""rect"",""x"":165,""y"":95,""width"":669,""height"":799}",{},799,rect,669,165,95,/home/dianwen/SIIM_ACR/train/images/1024/dicom/1.2.276.0.7230010.3.1.4.8323329.1327.1517875167.260042.png,/home/dianwen/SIIM_ACR/train/images/1024/mask/1.2.276.0.7230010.3.1.4.8323329.1327.1517875167.260042.png,0.0,0.0,894,834
1.2.276.0.7230010.3.1.4.8323329.1328.1517875167.265504.png,400195,{},1,0,"{""name"":""rect"",""x"":74,""y"":93,""width"":773,""height"":902}",{},902,rect,773,74,93,/home/dianwen/SIIM_ACR/train/images/1024/dicom/1.2.276.0.7230010.3.1.4.8323329.1328.1517875167.265504.png,/home/dianwen/SIIM_ACR/train/images/1024/mask/1.2.276.0.7230010.3.1.4.8323329.1328.1517875167.265504.png,0.005976676940917969,1.0,995,847
1.2.276.0.7230010.3.1.4.8323329.1329.1517875167.267293.png,431648,{},1,0,"{""name"":""rect"",""x"":51,""y"":126,""width"":918,""height"":733}",{},733,rect,918,51,126,/home/dianwen/SIIM_ACR/train/images/1024/dicom/1.2.276.0.7230010.3.1.4.8323329.1329.1517875167.267293.png,/home/dianwen/SIIM_ACR/train/images/1024/mask/1.2.276.0.7230010.3.1.4.8323329.1329.1517875167.267293.png,0.0,0.0,859,969
1.2.276.0.7230010.3.1.4.8323329.1330.1517875167.277281.png,373027,{},1,0,"{""name"":""rect"",""x"":59,""y"":104,""width"":693,""height"":842}",{},842,rect,693,59,104,/home/dianwen/SIIM_ACR/train/images/1024/dicom/1.2.276.0.7230010.3.1.4.8323329.1330.1517875167.277281.png,/home/dianwen/SIIM_ACR/train/images/1024/mask/1.2.276.0.7230010.3.1.4.8323329.1330.1517875167.277281.png,0.02136707305908203,1.0,946,752
1.2.276.0.7230010.3.1.4.8323329.1331.1517875167.268497.png,357172,{},1,0,"{""name"":""rect"",""x"":15,""y"":69,""width"":916,""height"":786}",{},786,rect,916,15,69,/home/dianwen/SIIM_ACR/train/images/1024/dicom/1.2.276.0.7230010.3.1.4.8323329.1331.1517875167.268497.png,/home/dianwen/SIIM_ACR/train/images/1024/mask/1.2.276.0.7230010.3.1.4.8323329.1331.1517875167.268497.png,0.0,0.0,855,931
1.2.276.0.7230010.3.1.4.8323329.1333.1517875167.281046.png,361616,{},1,0,"{""name"":""rect"",""x"":142,""y"":173,""width"":797,""height"":782}",{},782,rect,797,142,173,/home/dianwen/SIIM_ACR/train/images/1024/dicom/1.2.276.0.7230010.3.1.4.8323329.1333.1517875167.281046.png,/home/dianwen/SIIM_ACR/train/images/1024/mask/1.2.276.0.7230010.3.1.4.8323329.1333.1517875167.281046.png,0.0,0.0,955,939
1.2.276.0.7230010.3.1.4.8323329.1334.1517875167.289671.png,335346,{},1,0,"{""name"":""rect"",""x"":189,""y"":159,""width"":640,""height"":784}",{},784,rect,640,189,159,/home/dianwen/SIIM_ACR/train/images/1024/dicom/1.2.276.0.7230010.3.1.4.8323329.1334.1517875167.289671.png,/home/dianwen/SIIM_ACR/train/images/1024/mask/1.2.276.0.7230010.3.1.4.8323329.1334.1517875167.289671.png,0.0,0.0,943,829
1.2.276.0.7230010.3.1.4.8323329.1335.1517875167.296145.png,387457,{},1,0,"{""name"":""rect"",""x"":122,""y"":155,""width"":834,""height"":655}",{},655,rect,834,122,155,/home/dianwen/SIIM_ACR/train/images/1024/dicom/1.2.276.0.7230010.3.1.4.8323329.1335.1517875167.296145.png,/home/dianwen/SIIM_ACR/train/images/1024/mask/1.2.276.0.7230010.3.1.4.8323329.1335.1517875167.296145.png,0.0,0.0,810,956
1.2.276.0.7230010.3.1.4.8323329.1336.1517875167.288379.png,432016,{},1,0,"{""name"":""rect"",""x"":88,""y"":104,""width"":878,""height"":857}",{},857,rect,878,88,104,/home/dianwen/SIIM_ACR/train/images/1024/dicom/1.2.276.0.7230010.3.1.4.8323329.1336.1517875167.288379.png,/home/dianwen/SIIM_ACR/train/images/1024/mask/1.2.276.0.7230010.3.1.4.8323329.1336.1517875167.288379.png,0.0,0.0,961,966
1.2.276.0.7230010.3.1.4.8323329.1337.1517875167.297636.png,380928,{},1,0,"{""name"":""rect"",""x"":217,""y"":43,""width"":759,""height"":749}",{},749,rect,759,217,43,/home/dianwen/SIIM_ACR/train/images/1024/dicom/1.2.276.0.7230010.3.1.4.8323329.1337.1517875167.297636.png,/home/dianwen/SIIM_ACR/train/images/1024/mask/1.2.276.0.7230010.3.1.4.8323329.1337.1517875167.297636.png,0.07710456848144531,1.0,792,976
1.2.276.0.7230010.3.1.4.8323329.1338.1517875167.308295.png,420815,{},1,0,"{""name"":""rect"",""x"":100,""y"":145,""width"":829,""height"":699}",{},699,rect,829,100,145,/home/dianwen/SIIM_ACR/train/images/1024/dicom/1.2.276.0.7230010.3.1.4.8323329.1338.1517875167.308295.png,/home/dianwen/SIIM_ACR/train/images/1024/mask/1.2.276.0.7230010.3.1.4.8323329.1338.1517875167.308295.png,0.0,0.0,844,929
1.2.276.0.7230010.3.1.4.8323329.1339.1517875167.304186.png,421805,{},1,0,"{""name"":""rect"",""x"":58,""y"":111,""width"":953,""height"":714}",{},714,rect,953,58,111,/home/dianwen/SIIM_ACR/train/images/1024/dicom/1.2.276.0.7230010.3.1.4.8323329.1339.1517875167.304186.png,/home/dianwen/SIIM_ACR/train/images/1024/mask/1.2.276.0.7230010.3.1.4.8323329.1339.1517875167.304186.png,0.0036764144897460938,1.0,825,1011
1.2.276.0.7230010.3.1.4.8323329.1340.1517875167.307866.png,391993,{},1,0,"{""name"":""rect"",""x"":5,""y"":43,""width"":922,""height"":818}",{},818,rect,922,5,43,/home/dianwen/SIIM_ACR/train/images/1024/dicom/1.2.276.0.7230010.3.1.4.8323329.1340.1517875167.307866.png,/home/dianwen/SIIM_ACR/train/images/1024/mask/1.2.276.0.7230010.3.1.4.8323329.1340.1517875167.307866.png,0.0,0.0,861,927
1.2.276.0.7230010.3.1.4.8323329.1341.1517875167.313816.png,361937,{},1,0,"{""name"":""rect"",""x"":33,""y"":89,""width"":921,""height"":928}",{},928,rect,921,33,89,/home/dianwen/SIIM_ACR/train/images/1024/dicom/1.2.276.0.7230010.3.1.4.8323329.1341.1517875167.313816.png,/home/dianwen/SIIM_ACR/train/images/1024/mask/1.2.276.0.7230010.3.1.4.8323329.1341.1517875167.313816.png,0.0,0.0,1017,954
1.2.276.0.7230010.3.1.4.8323329.1342.1517875167.316049.png,327415,{},1,0,"{""name"":""rect"",""x"":191,""y"":26,""width"":734,""height"":762}",{},762,rect,734,191,26,/home/dianwen/SIIM_ACR/train/images/1024/dicom/1.2.276.0.7230010.3.1.4.8323329.1342.1517875167.316049.png,/home/dianwen/SIIM_ACR/train/images/1024/mask/1.2.276.0.7230010.3.1.4.8323329.1342.1517875167.316049.png,0.0,0.0,788,925
1.2.276.0.7230010.3.1.4.8323329.1343.1517875167.318282.png,352401,{},1,0,"{""name"":""rect"",""x"":162,""y"":138,""width"":850,""height"":880}",{},880,rect,850,162,138,/home/dianwen/SIIM_ACR/train/images/1024/dicom/1.2.276.0.7230010.3.1.4.8323329.1343.1517875167.318282.png,/home/dianwen/SIIM_ACR/train/images/1024/mask/1.2.276.0.7230010.3.1.4.8323329.1343.1517875167.318282.png,0.0,0.0,1018,1012
1.2.276.0.7230010.3.1.4.8323329.1344.1517875167.320441.png,347452,{},1,0,"{""name"":""rect"",""x"":95,""y"":27,""width"":731,""height"":878}",{},878,rect,731,95,27,/home/dianwen/SIIM_ACR/train/images/1024/dicom/1.2.276.0.7230010.3.1.4.8323329.1344.1517875167.320441.png,/home/dianwen/SIIM_ACR/train/images/1024/mask/1.2.276.0.7230010.3.1.4.8323329.1344.1517875167.320441.png,0.0,0.0,905,826
1.2.276.0.7230010.3.1.4.8323329.1345.1517875167.321999.png,433056,{},1,0,"{""name"":""rect"",""x"":41,""y"":130,""width"":928,""height"":732}",{},732,rect,928,41,130,/home/dianwen/SIIM_ACR/train/images/1024/dicom/1.2.276.0.7230010.3.1.4.8323329.1345.1517875167.321999.png,/home/dianwen/SIIM_ACR/train/images/1024/mask/1.2.276.0.7230010.3.1.4.8323329.1345.1517875167.321999.png,0.0,0.0,862,969
1.2.276.0.7230010.3.1.4.8323329.1346.1517875167.332993.png,279236,{},1,0,"{""name"":""rect"",""x"":159,""y"":91,""width"":795,""height"":760}",{},760,rect,795,159,91,/home/dianwen/SIIM_ACR/train/images/1024/dicom/1.2.276.0.7230010.3.1.4.8323329.1346.1517875167.332993.png,/home/dianwen/SIIM_ACR/train/images/1024/mask/1.2.276.0.7230010.3.1.4.8323329.1346.1517875167.332993.png,0.0,0.0,851,954
1.2.276.0.7230010.3.1.4.8323329.1347.1517875167.336188.png,310261,{},1,0,"{""name"":""rect"",""x"":190,""y"":76,""width"":696,""height"":741}",{},741,rect,696,190,76,/home/dianwen/SIIM_ACR/train/images/1024/dicom/1.2.276.0.7230010.3.1.4.8323329.1347.1517875167.336188.png,/home/dianwen/SIIM_ACR/train/images/1024/mask/1.2.276.0.7230010.3.1.4.8323329.1347.1517875167.336188.png,0.0,0.0,817,886
1.2.276.0.7230010.3.1.4.8323329.1348.1517875167.336440.png,337669,{},1,0,"{""name"":""rect"",""x"":79,""y"":99,""width"":842,""height"":736}",{},736,rect,842,79,99,/home/dianwen/SIIM_ACR/train/images/1024/dicom/1.2.276.0.7230010.3.1.4.8323329.1348.1517875167.336440.png,/home/dianwen/SIIM_ACR/train/images/1024/mask/1.2.276.0.7230010.3.1.4.8323329.1348.1517875167.336440.png,0.00548553466796875,1.0,835,921
1.2.276.0.7230010.3.1.4.8323329.1349.1517875167.351429.png,465537,{},1,0,"{""name"":""rect"",""x"":21,""y"":44,""width"":907,""height"":931}",{},931,rect,907,21,44,/home/dianwen/SIIM_ACR/train/images/1024/dicom/1.2.276.0.7230010.3.1.4.8323329.1349.1517875167.351429.png,/home/dianwen/SIIM_ACR/train/images/1024/mask/1.2.276.0.7230010.3.1.4.8323329.1349.1517875167.351429.png,0.0,0.0,975,928
1.2.276.0.7230010.3.1.4.8323329.1350.1517875167.344740.png,350713,{},1,0,"{""name"":""rect"",""x"":221,""y"":97,""width"":671,""height"":737}",{},737,rect,671,221,97,/home/dianwen/SIIM_ACR/train/images/1024/dicom/1.2.276.0.7230010.3.1.4.8323329.1350.1517875167.344740.png,/home/dianwen/SIIM_ACR/train/images/1024/mask/1.2.276.0.7230010.3.1.4.8323329.1350.1517875167.344740.png,0.0,0.0,834,892
1.2.276.0.7230010.3.1.4.8323329.1351.1517875167.356604.png,321585,{},1,0,"{""name"":""rect"",""x"":228,""y"":80,""width"":673,""height"":712}",{},712,rect,673,228,80,/home/dianwen/SIIM_ACR/train/images/1024/dicom/1.2.276.0.7230010.3.1.4.8323329.1351.1517875167.356604.png,/home/dianwen/SIIM_ACR/train/images/1024/mask/1.2.276.0.7230010.3.1.4.8323329.1351.1517875167.356604.png,0.0,0.0,792,901
1.2.276.0.7230010.3.1.4.8323329.1352.1517875167.355420.png,342004,{},1,0,"{""name"":""rect"",""x"":77,""y"":215,""width"":838,""height"":689}",{},689,rect,838,77,215,/home/dianwen/SIIM_ACR/train/images/1024/dicom/1.2.276.0.7230010.3.1.4.8323329.1352.1517875167.355420.png,/home/dianwen/SIIM_ACR/train/images/1024/mask/1.2.276.0.7230010.3.1.4.8323329.1352.1517875167.355420.png,0.0,0.0,904,915
1.2.276.0.7230010.3.1.4.8323329.1353.1517875167.355882.png,417047,{},1,0,"{""name"":""rect"",""x"":2,""y"":179,""width"":830,""height"":776}",{},776,rect,830,2,179,/home/dianwen/SIIM_ACR/train/images/1024/dicom/1.2.276.0.7230010.3.1.4.8323329.1353.1517875167.355882.png,/home/dianwen/SIIM_ACR/train/images/1024/mask/1.2.276.0.7230010.3.1.4.8323329.1353.1517875167.355882.png,0.0,0.0,955,832
1.2.276.0.7230010.3.1.4.8323329.1354.1517875167.356575.png,336475,{},1,0,"{""name"":""rect"",""x"":70,""y"":202,""width"":817,""height"":677}",{},677,rect,817,70,202,/home/dianwen/SIIM_ACR/train/images/1024/dicom/1.2.276.0.7230010.3.1.4.8323329.1354.1517875167.356575.png,/home/dianwen/SIIM_ACR/train/images/1024/mask/1.2.276.0.7230010.3.1.4.8323329.1354.1517875167.356575.png,0.0,0.0,879,887
1.2.276.0.7230010.3.1.4.8323329.1355.1517875167.358207.png,308102,{},1,0,"{""name"":""rect"",""x"":225,""y"":187,""width"":725,""height"":809}",{},809,rect,725,225,187,/home/dianwen/SIIM_ACR/train/images/1024/dicom/1.2.276.0.7230010.3.1.4.8323329.1355.1517875167.358207.png,/home/dianwen/SIIM_ACR/train/images/1024/mask/1.2.276.0.7230010.3.1.4.8323329.1355.1517875167.358207.png,0.0,0.0,996,950
1.2.276.0.7230010.3.1.4.8323329.1356.1517875167.366221.png,415471,{},1,0,"{""name"":""rect"",""x"":150,""y"":99,""width"":703,""height"":646}",{},646,rect,703,150,99,/home/dianwen/SIIM_ACR/train/images/1024/dicom/1.2.276.0.7230010.3.1.4.8323329.1356.1517875167.366221.png,/home/dianwen/SIIM_ACR/train/images/1024/mask/1.2.276.0.7230010.3.1.4.8323329.1356.1517875167.366221.png,0.008360862731933594,1.0,745,853
1.2.276.0.7230010.3.1.4.8323329.1357.1517875167.375733.png,431660,{},1,0,"{""name"":""rect"",""x"":121,""y"":88,""width"":796,""height"":868}",{},868,rect,796,121,88,/home/dianwen/SIIM_ACR/train/images/1024/dicom/1.2.276.0.7230010.3.1.4.8323329.1357.1517875167.375733.png,/home/dianwen/SIIM_ACR/train/images/1024/mask/1.2.276.0.7230010.3.1.4.8323329.1357.1517875167.375733.png,0.003355979919433593,1.0,956,917
1.2.276.0.7230010.3.1.4.8323329.1358.1517875167.376032.png,364852,{},1,0,"{""name"":""rect"",""x"":89,""y"":25,""width"":842,""height"":978}",{},978,rect,842,89,25,/home/dianwen/SIIM_ACR/train/images/1024/dicom/1.2.276.0.7230010.3.1.4.8323329.1358.1517875167.376032.png,/home/dianwen/SIIM_ACR/train/images/1024/mask/1.2.276.0.7230010.3.1.4.8323329.1358.1517875167.376032.png,0.0,0.0,1003,931
1.2.276.0.7230010.3.1.4.8323329.1359.1517875167.385423.png,328716,{},1,0,"{""name"":""rect"",""x"":33,""y"":321,""width"":788,""height"":703}",{},703,rect,788,33,321,/home/dianwen/SIIM_ACR/train/images/1024/dicom/1.2.276.0.7230010.3.1.4.8323329.1359.1517875167.385423.png,/home/dianwen/SIIM_ACR/train/images/1024/mask/1.2.276.0.7230010.3.1.4.8323329.1359.1517875167.385423.png,0.0,0.0,1024,821
1.2.276.0.7230010.3.1.4.8323329.1360.1517875167.392182.png,369372,{},1,0,"{""name"":""rect"",""x"":43,""y"":123,""width"":854,""height"":877}",{},877,rect,854,43,123,/home/dianwen/SIIM_ACR/train/images/1024/dicom/1.2.276.0.7230010.3.1.4.8323329.1360.1517875167.392182.png,/home/dianwen/SIIM_ACR/train/images/1024/mask/1.2.276.0.7230010.3.1.4.8323329.1360.1517875167.392182.png,0.0,0.0,1000,897
1.2.276.0.7230010.3.1.4.8323329.1361.1517875167.387853.png,349255,{},1,0,"{""name"":""rect"",""x"":156,""y"":140,""width"":809,""height"":862}",{},862,rect,809,156,140,/home/dianwen/SIIM_ACR/train/images/1024/dicom/1.2.276.0.7230010.3.1.4.8323329.1361.1517875167.387853.png,/home/dianwen/SIIM_ACR/train/images/1024/mask/1.2.276.0.7230010.3.1.4.8323329.1361.1517875167.387853.png,0.007046699523925781,1.0,1002,965
1.2.276.0.7230010.3.1.4.8323329.1362.1517875167.395422.png,394981,{},1,0,"{""name"":""rect"",""x"":27,""y"":135,""width"":877,""height"":837}",{},837,rect,877,27,135,/home/dianwen/SIIM_ACR/train/images/1024/dicom/1.2.276.0.7230010.3.1.4.8323329.1362.1517875167.395422.png,/home/dianwen/SIIM_ACR/train/images/1024/mask/1.2.276.0.7230010.3.1.4.8323329.1362.1517875167.395422.png,0.0,0.0,972,904
1.2.276.0.7230010.3.1.4.8323329.1363.1517875167.404640.png,433490,{},1,0,"{""name"":""rect"",""x"":105,""y"":113,""width"":800,""height"":854}",{},854,rect,800,105,113,/home/dianwen/SIIM_ACR/train/images/1024/dicom/1.2.276.0.7230010.3.1.4.8323329.1363.1517875167.404640.png,/home/dianwen/SIIM_ACR/train/images/1024/mask/1.2.276.0.7230010.3.1.4.8323329.1363.1517875167.404640.png,0.0,0.0,967,905
1.2.276.0.7230010.3.1.4.8323329.1364.1517875167.405481.png,356190,{},1,0,"{""name"":""rect"",""x"":54,""y"":61,""width"":965,""height"":890}",{},890,rect,965,54,61,/home/dianwen/SIIM_ACR/train/images/1024/dicom/1.2.276.0.7230010.3.1.4.8323329.1364.1517875167.405481.png,/home/dianwen/SIIM_ACR/train/images/1024/mask/1.2.276.0.7230010.3.1.4.8323329.1364.1517875167.405481.png,0.0,0.0,951,1019
1.2.276.0.7230010.3.1.4.8323329.1365.1517875167.410244.png,419445,{},1,0,"{""name"":""rect"",""x"":55,""y"":113,""width"":711,""height"":784}",{},784,rect,711,55,113,/home/dianwen/SIIM_ACR/train/images/1024/dicom/1.2.276.0.7230010.3.1.4.8323329.1365.1517875167.410244.png,/home/dianwen/SIIM_ACR/train/images/1024/mask/1.2.276.0.7230010.3.1.4.8323329.1365.1517875167.410244.png,0.0,0.0,897,766
1.2.276.0.7230010.3.1.4.8323329.1366.1517875167.409983.png,369888,{},1,0,"{""name"":""rect"",""x"":68,""y"":32,""width"":847,""height"":976}",{},976,rect,847,68,32,/home/dianwen/SIIM_ACR/train/images/1024/dicom/1.2.276.0.7230010.3.1.4.8323329.1366.1517875167.409983.png,/home/dianwen/SIIM_ACR/train/images/1024/mask/1.2.276.0.7230010.3.1.4.8323329.1366.1517875167.409983.png,0.0161285400390625,1.0,1008,915
1.2.276.0.7230010.3.1.4.8323329.1367.1517875167.414572.png,426942,{},1,0,"{""name"":""rect"",""x"":80,""y"":151,""width"":903,""height"":745}",{},745,rect,903,80,151,/home/dianwen/SIIM_ACR/train/images/1024/dicom/1.2.276.0.7230010.3.1.4.8323329.1367.1517875167.414572.png,/home/dianwen/SIIM_ACR/train/images/1024/mask/1.2.276.0.7230010.3.1.4.8323329.1367.1517875167.414572.png,0.0,0.0,896,983
1.2.276.0.7230010.3.1.4.8323329.1368.1517875167.423436.png,407563,{},1,0,"{""name"":""rect"",""x"":117,""y"":70,""width"":824,""height"":746}",{},746,rect,824,117,70,/home/dianwen/SIIM_ACR/train/images/1024/dicom/1.2.276.0.7230010.3.1.4.8323329.1368.1517875167.423436.png,/home/dianwen/SIIM_ACR/train/images/1024/mask/1.2.276.0.7230010.3.1.4.8323329.1368.1517875167.423436.png,0.025007247924804688,1.0,816,941
1.2.276.0.7230010.3.1.4.8323329.1369.1517875167.422571.png,409962,{},1,0,"{""name"":""rect"",""x"":140,""y"":95,""width"":794,""height"":854}",{},854,rect,794,140,95,/home/dianwen/SIIM_ACR/train/images/1024/dicom/1.2.276.0.7230010.3.1.4.8323329.1369.1517875167.422571.png,/home/dianwen/SIIM_ACR/train/images/1024/mask/1.2.276.0.7230010.3.1.4.8323329.1369.1517875167.422571.png,0.0,0.0,949,934
1.2.276.0.7230010.3.1.4.8323329.1370.1517875167.425534.png,434368,{},1,0,"{""name"":""rect"",""x"":49,""y"":102,""width"":892,""height"":849}",{},849,rect,892,49,102,/home/dianwen/SIIM_ACR/train/images/1024/dicom/1.2.276.0.7230010.3.1.4.8323329.1370.1517875167.425534.png,/home/dianwen/SIIM_ACR/train/images/1024/mask/1.2.276.0.7230010.3.1.4.8323329.1370.1517875167.425534.png,0.0,0.0,951,941
1.2.276.0.7230010.3.1.4.8323329.1371.1517875167.425949.png,245589,{},1,0,"{""name"":""rect"",""x"":223,""y"":194,""width"":584,""height"":474}",{},474,rect,584,223,194,/home/dianwen/SIIM_ACR/train/images/1024/dicom/1.2.276.0.7230010.3.1.4.8323329.1371.1517875167.425949.png,/home/dianwen/SIIM_ACR/train/images/1024/mask/1.2.276.0.7230010.3.1.4.8323329.1371.1517875167.425949.png,0.0,0.0,668,807
1.2.276.0.7230010.3.1.4.8323329.1372.1517875167.438116.png,289589,{},1,0,"{""name"":""rect"",""x"":82,""y"":54,""width"":828,""height"":771}",{},771,rect,828,82,54,/home/dianwen/SIIM_ACR/train/images/1024/dicom/1.2.276.0.7230010.3.1.4.8323329.1372.1517875167.438116.png,/home/dianwen/SIIM_ACR/train/images/1024/mask/1.2.276.0.7230010.3.1.4.8323329.1372.1517875167.438116.png,0.0,0.0,825,910
1.2.276.0.7230010.3.1.4.8323329.1373.1517875167.436022.png,356745,{},1,0,"{""name"":""rect"",""x"":103,""y"":25,""width"":812,""height"":853}",{},853,rect,812,103,25,/home/dianwen/SIIM_ACR/train/images/1024/dicom/1.2.276.0.7230010.3.1.4.8323329.1373.1517875167.436022.png,/home/dianwen/SIIM_ACR/train/images/1024/mask/1.2.276.0.7230010.3.1.4.8323329.1373.1517875167.436022.png,0.0,0.0,878,915
1.2.276.0.7230010.3.1.4.8323329.1374.1517875167.438882.png,355831,{},1,0,"{""name"":""rect"",""x"":116,""y"":77,""width"":880,""height"":941}",{},941,rect,880,116,77,/home/dianwen/SIIM_ACR/train/images/1024/dicom/1.2.276.0.7230010.3.1.4.8323329.1374.1517875167.438882.png,/home/dianwen/SIIM_ACR/train/images/1024/mask/1.2.276.0.7230010.3.1.4.8323329.1374.1517875167.438882.png,0.0015153884887695312,1.0,1018,996
1.2.276.0.7230010.3.1.4.8323329.1375.1517875167.449580.png,359209,{},1,0,"{""name"":""rect"",""x"":48,""y"":126,""width"":831,""height"":896}",{},896,rect,831,48,126,/home/dianwen/SIIM_ACR/train/images/1024/dicom/1.2.276.0.7230010.3.1.4.8323329.1375.1517875167.449580.png,/home/dianwen/SIIM_ACR/train/images/1024/mask/1.2.276.0.7230010.3.1.4.8323329.1375.1517875167.449580.png,0.0,0.0,1022,879
1.2.276.0.7230010.3.1.4.8323329.1376.1517875167.447303.png,423820,{},1,0,"{""name"":""rect"",""x"":75,""y"":98,""width"":872,""height"":790}",{},790,rect,872,75,98,/home/dianwen/SIIM_ACR/train/images/1024/dicom/1.2.276.0.7230010.3.1.4.8323329.1376.1517875167.447303.png,/home/dianwen/SIIM_ACR/train/images/1024/mask/1.2.276.0.7230010.3.1.4.8323329.1376.1517875167.447303.png,0.0,0.0,888,947
1.2.276.0.7230010.3.1.4.8323329.1377.1517875167.449611.png,412390,{},1,0,"{""name"":""rect"",""x"":119,""y"":28,""width"":747,""height"":840}",{},840,rect,747,119,28,/home/dianwen/SIIM_ACR/train/images/1024/dicom/1.2.276.0.7230010.3.1.4.8323329.1377.1517875167.449611.png,/home/dianwen/SIIM_ACR/train/images/1024/mask/1.2.276.0.7230010.3.1.4.8323329.1377.1517875167.449611.png,0.0,0.0,868,866
1.2.276.0.7230010.3.1.4.8323329.1378.1517875167.457297.png,339094,{},1,0,"{""name"":""rect"",""x"":113,""y"":117,""width"":755,""height"":831}",{},831,rect,755,113,117,/home/dianwen/SIIM_ACR/train/images/1024/dicom/1.2.276.0.7230010.3.1.4.8323329.1378.1517875167.457297.png,/home/dianwen/SIIM_ACR/train/images/1024/mask/1.2.276.0.7230010.3.1.4.8323329.1378.1517875167.457297.png,0.0,0.0,948,868
1.2.276.0.7230010.3.1.4.8323329.1379.1517875167.457720.png,420305,{},1,0,"{""name"":""rect"",""x"":25,""y"":13,""width"":916,""height"":1008}",{},1008,rect,916,25,13,/home/dianwen/SIIM_ACR/train/images/1024/dicom/1.2.276.0.7230010.3.1.4.8323329.1379.1517875167.457720.png,/home/dianwen/SIIM_ACR/train/images/1024/mask/1.2.276.0.7230010.3.1.4.8323329.1379.1517875167.457720.png,0.006251335144042969,1.0,1021,941
1.2.276.0.7230010.3.1.4.8323329.1380.1517875167.464687.png,364000,{},1,0,"{""name"":""rect"",""x"":53,""y"":230,""width"":796,""height"":631}",{},631,rect,796,53,230,/home/dianwen/SIIM_ACR/train/images/1024/dicom/1.2.276.0.7230010.3.1.4.8323329.1380.1517875167.464687.png,/home/dianwen/SIIM_ACR/train/images/1024/mask/1.2.276.0.7230010.3.1.4.8323329.1380.1517875167.464687.png,0.0,0.0,861,849
1.2.276.0.7230010.3.1.4.8323329.1381.1517875167.468427.png,343920,{},1,0,"{""name"":""rect"",""x"":63,""y"":194,""width"":872,""height"":828}",{},828,rect,872,63,194,/home/dianwen/SIIM_ACR/train/images/1024/dicom/1.2.276.0.7230010.3.1.4.8323329.1381.1517875167.468427.png,/home/dianwen/SIIM_ACR/train/images/1024/mask/1.2.276.0.7230010.3.1.4.8323329.1381.1517875167.468427.png,0.0,0.0,1022,935
1.2.276.0.7230010.3.1.4.8323329.1382.1517875167.471105.png,396500,{},1,0,"{""name"":""rect"",""x"":37,""y"":78,""width"":958,""height"":806}",{},806,rect,958,37,78,/home/dianwen/SIIM_ACR/train/images/1024/dicom/1.2.276.0.7230010.3.1.4.8323329.1382.1517875167.471105.png,/home/dianwen/SIIM_ACR/train/images/1024/mask/1.2.276.0.7230010.3.1.4.8323329.1382.1517875167.471105.png,0.0,0.0,884,995
1.2.276.0.7230010.3.1.4.8323329.1383.1517875167.478352.png,391484,{},1,0,"{""name"":""rect"",""x"":38,""y"":28,""width"":868,""height"":963}",{},963,rect,868,38,28,/home/dianwen/SIIM_ACR/train/images/1024/dicom/1.2.276.0.7230010.3.1.4.8323329.1383.1517875167.478352.png,/home/dianwen/SIIM_ACR/train/images/1024/mask/1.2.276.0.7230010.3.1.4.8323329.1383.1517875167.478352.png,0.0,0.0,991,906
1.2.276.0.7230010.3.1.4.8323329.1384.1517875167.488837.png,329382,{},1,0,"{""name"":""rect"",""x"":128,""y"":154,""width"":812,""height"":834}",{},834,rect,812,128,154,/home/dianwen/SIIM_ACR/train/images/1024/dicom/1.2.276.0.7230010.3.1.4.8323329.1384.1517875167.488837.png,/home/dianwen/SIIM_ACR/train/images/1024/mask/1.2.276.0.7230010.3.1.4.8323329.1384.1517875167.488837.png,0.0,0.0,988,940
1.2.276.0.7230010.3.1.4.8323329.1385.1517875167.491494.png,396345,{},1,0,"{""name"":""rect"",""x"":162,""y"":55,""width"":683,""height"":806}",{},806,rect,683,162,55,/home/dianwen/SIIM_ACR/train/images/1024/dicom/1.2.276.0.7230010.3.1.4.8323329.1385.1517875167.491494.png,/home/dianwen/SIIM_ACR/train/images/1024/mask/1.2.276.0.7230010.3.1.4.8323329.1385.1517875167.491494.png,0.0,0.0,861,845
1.2.276.0.7230010.3.1.4.8323329.1386.1517875167.491794.png,294608,{},1,0,"{""name"":""rect"",""x"":140,""y"":175,""width"":817,""height"":696}",{},696,rect,817,140,175,/home/dianwen/SIIM_ACR/train/images/1024/dicom/1.2.276.0.7230010.3.1.4.8323329.1386.1517875167.491794.png,/home/dianwen/SIIM_ACR/train/images/1024/mask/1.2.276.0.7230010.3.1.4.8323329.1386.1517875167.491794.png,0.0,0.0,871,957
1.2.276.0.7230010.3.1.4.8323329.1387.1517875167.496523.png,402989,{},1,0,"{""name"":""rect"",""x"":138,""y"":152,""width"":776,""height"":802}",{},802,rect,776,138,152,/home/dianwen/SIIM_ACR/train/images/1024/dicom/1.2.276.0.7230010.3.1.4.8323329.1387.1517875167.496523.png,/home/dianwen/SIIM_ACR/train/images/1024/mask/1.2.276.0.7230010.3.1.4.8323329.1387.1517875167.496523.png,0.0,0.0,954,914
1.2.276.0.7230010.3.1.4.8323329.1388.1517875167.509811.png,360951,{},1,0,"{""name"":""rect"",""x"":19,""y"":52,""width"":875,""height"":853}",{},853,rect,875,19,52,/home/dianwen/SIIM_ACR/train/images/1024/dicom/1.2.276.0.7230010.3.1.4.8323329.1388.1517875167.509811.png,/home/dianwen/SIIM_ACR/train/images/1024/mask/1.2.276.0.7230010.3.1.4.8323329.1388.1517875167.509811.png,0.0,0.0,905,894
1.2.276.0.7230010.3.1.4.8323329.1389.1517875167.508735.png,417462,{},1,0,"{""name"":""rect"",""x"":234,""y"":111,""width"":624,""height"":772}",{},772,rect,624,234,111,/home/dianwen/SIIM_ACR/train/images/1024/dicom/1.2.276.0.7230010.3.1.4.8323329.1389.1517875167.508735.png,/home/dianwen/SIIM_ACR/train/images/1024/mask/1.2.276.0.7230010.3.1.4.8323329.1389.1517875167.508735.png,0.0,0.0,883,858
1.2.276.0.7230010.3.1.4.8323329.1390.1517875167.512105.png,414552,{},1,0,"{""name"":""rect"",""x"":81,""y"":51,""width"":820,""height"":750}",{},750,rect,820,81,51,/home/dianwen/SIIM_ACR/train/images/1024/dicom/1.2.276.0.7230010.3.1.4.8323329.1390.1517875167.512105.png,/home/dianwen/SIIM_ACR/train/images/1024/mask/1.2.276.0.7230010.3.1.4.8323329.1390.1517875167.512105.png,0.0,0.0,801,901
1.2.276.0.7230010.3.1.4.8323329.1391.1517875167.512104.png,353253,{},1,0,"{""name"":""rect"",""x"":140,""y"":129,""width"":696,""height"":813}",{},813,rect,696,140,129,/home/dianwen/SIIM_ACR/train/images/1024/dicom/1.2.276.0.7230010.3.1.4.8323329.1391.1517875167.512104.png,/home/dianwen/SIIM_ACR/train/images/1024/mask/1.2.276.0.7230010.3.1.4.8323329.1391.1517875167.512104.png,0.0,0.0,942,836
1.2.276.0.7230010.3.1.4.8323329.1393.1517875167.516965.png,425128,{},1,0,"{""name"":""rect"",""x"":77,""y"":107,""width"":878,""height"":838}",{},838,rect,878,77,107,/home/dianwen/SIIM_ACR/train/images/1024/dicom/1.2.276.0.7230010.3.1.4.8323329.1393.1517875167.516965.png,/home/dianwen/SIIM_ACR/train/images/1024/mask/1.2.276.0.7230010.3.1.4.8323329.1393.1517875167.516965.png,0.0,0.0,945,955
1.2.276.0.7230010.3.1.4.8323329.1394.1517875167.527839.png,361523,{},1,0,"{""name"":""rect"",""x"":96,""y"":92,""width"":880,""height"":902}",{},902,rect,880,96,92,/home/dianwen/SIIM_ACR/train/images/1024/dicom/1.2.276.0.7230010.3.1.4.8323329.1394.1517875167.527839.png,/home/dianwen/SIIM_ACR/train/images/1024/mask/1.2.276.0.7230010.3.1.4.8323329.1394.1517875167.527839.png,0.016684532165527344,1.0,994,976
1.2.276.0.7230010.3.1.4.8323329.1395.1517875167.535037.png,438720,{},1,0,"{""name"":""rect"",""x"":71,""y"":72,""width"":898,""height"":814}",{},814,rect,898,71,72,/home/dianwen/SIIM_ACR/train/images/1024/dicom/1.2.276.0.7230010.3.1.4.8323329.1395.1517875167.535037.png,/home/dianwen/SIIM_ACR/train/images/1024/mask/1.2.276.0.7230010.3.1.4.8323329.1395.1517875167.535037.png,0.0,0.0,886,969
1.2.276.0.7230010.3.1.4.8323329.1396.1517875167.537609.png,359938,{},1,0,"{""name"":""rect"",""x"":108,""y"":47,""width"":892,""height"":892}",{},892,rect,892,108,47,/home/dianwen/SIIM_ACR/train/images/1024/dicom/1.2.276.0.7230010.3.1.4.8323329.1396.1517875167.537609.png,/home/dianwen/SIIM_ACR/train/images/1024/mask/1.2.276.0.7230010.3.1.4.8323329.1396.1517875167.537609.png,0.0,0.0,939,1000
1.2.276.0.7230010.3.1.4.8323329.1397.1517875167.553451.png,376002,{},1,0,"{""name"":""rect"",""x"":237,""y"":104,""width"":749,""height"":814}",{},814,rect,749,237,104,/home/dianwen/SIIM_ACR/train/images/1024/dicom/1.2.276.0.7230010.3.1.4.8323329.1397.1517875167.553451.png,/home/dianwen/SIIM_ACR/train/images/1024/mask/1.2.276.0.7230010.3.1.4.8323329.1397.1517875167.553451.png,0.0,0.0,918,986
1.2.276.0.7230010.3.1.4.8323329.1398.1517875167.552850.png,412605,{},1,0,"{""name"":""rect"",""x"":115,""y"":133,""width"":818,""height"":789}",{},789,rect,818,115,133,/home/dianwen/SIIM_ACR/train/images/1024/dicom/1.2.276.0.7230010.3.1.4.8323329.1398.1517875167.552850.png,/home/dianwen/SIIM_ACR/train/images/1024/mask/1.2.276.0.7230010.3.1.4.8323329.1398.1517875167.552850.png,0.0,0.0,922,933
1.2.276.0.7230010.3.1.4.8323329.1399.1517875167.554758.png,430475,{},1,0,"{""name"":""rect"",""x"":42,""y"":82,""width"":883,""height"":807}",{},807,rect,883,42,82,/home/dianwen/SIIM_ACR/train/images/1024/dicom/1.2.276.0.7230010.3.1.4.8323329.1399.1517875167.554758.png,/home/dianwen/SIIM_ACR/train/images/1024/mask/1.2.276.0.7230010.3.1.4.8323329.1399.1517875167.554758.png,0.0,0.0,889,925
1.2.276.0.7230010.3.1.4.8323329.1400.1517875167.556201.png,281121,{},1,0,"{""name"":""rect"",""x"":232,""y"":289,""width"":629,""height"":589}",{},589,rect,629,232,289,/home/dianwen/SIIM_ACR/train/images/1024/dicom/1.2.276.0.7230010.3.1.4.8323329.1400.1517875167.556201.png,/home/dianwen/SIIM_ACR/train/images/1024/mask/1.2.276.0.7230010.3.1.4.8323329.1400.1517875167.556201.png,0.0,0.0,878,861
1.2.276.0.7230010.3.1.4.8323329.1401.1517875167.558474.png,410694,{},1,0,"{""name"":""rect"",""x"":132,""y"":117,""width"":790,""height"":831}",{},831,rect,790,132,117,/home/dianwen/SIIM_ACR/train/images/1024/dicom/1.2.276.0.7230010.3.1.4.8323329.1401.1517875167.558474.png,/home/dianwen/SIIM_ACR/train/images/1024/mask/1.2.276.0.7230010.3.1.4.8323329.1401.1517875167.558474.png,0.0,0.0,948,922
1.2.276.0.7230010.3.1.4.8323329.1402.1517875167.562778.png,396955,{},1,0,"{""name"":""rect"",""x"":99,""y"":6,""width"":728,""height"":610}",{},610,rect,728,99,6,/home/dianwen/SIIM_ACR/train/images/1024/dicom/1.2.276.0.7230010.3.1.4.8323329.1402.1517875167.562778.png,/home/dianwen/SIIM_ACR/train/images/1024/mask/1.2.276.0.7230010.3.1.4.8323329.1402.1517875167.562778.png,0.0,0.0,616,827
1.2.276.0.7230010.3.1.4.8323329.1403.1517875167.583885.png,374848,{},1,0,"{""name"":""rect"",""x"":151,""y"":61,""width"":729,""height"":721}",{},721,rect,729,151,61,/home/dianwen/SIIM_ACR/train/images/1024/dicom/1.2.276.0.7230010.3.1.4.8323329.1403.1517875167.583885.png,/home/dianwen/SIIM_ACR/train/images/1024/mask/1.2.276.0.7230010.3.1.4.8323329.1403.1517875167.583885.png,0.0,0.0,782,880
1.2.276.0.7230010.3.1.4.8323329.1404.1517875167.584435.png,413222,{},1,0,"{""name"":""rect"",""x"":106,""y"":135,""width"":775,""height"":765}",{},765,rect,775,106,135,/home/dianwen/SIIM_ACR/train/images/1024/dicom/1.2.276.0.7230010.3.1.4.8323329.1404.1517875167.584435.png,/home/dianwen/SIIM_ACR/train/images/1024/mask/1.2.276.0.7230010.3.1.4.8323329.1404.1517875167.584435.png,0.0,0.0,900,881
1.2.276.0.7230010.3.1.4.8323329.1405.1517875167.586281.png,447270,{},1,0,"{""name"":""rect"",""x"":68,""y"":49,""width"":915,""height"":846}",{},846,rect,915,68,49,/home/dianwen/SIIM_ACR/train/images/1024/dicom/1.2.276.0.7230010.3.1.4.8323329.1405.1517875167.586281.png,/home/dianwen/SIIM_ACR/train/images/1024/mask/1.2.276.0.7230010.3.1.4.8323329.1405.1517875167.586281.png,0.0,0.0,895,983
1.2.276.0.7230010.3.1.4.8323329.1406.1517875167.601948.png,422400,{},1,0,"{""name"":""rect"",""x"":147,""y"":133,""width"":810,""height"":824}",{},824,rect,810,147,133,/home/dianwen/SIIM_ACR/train/images/1024/dicom/1.2.276.0.7230010.3.1.4.8323329.1406.1517875167.601948.png,/home/dianwen/SIIM_ACR/train/images/1024/mask/1.2.276.0.7230010.3.1.4.8323329.1406.1517875167.601948.png,0.0023670196533203125,1.0,957,957
1.2.276.0.7230010.3.1.4.8323329.1407.1517875167.596214.png,444882,{},1,0,"{""name"":""rect"",""x"":53,""y"":93,""width"":938,""height"":822}",{},822,rect,938,53,93,/home/dianwen/SIIM_ACR/train/images/1024/dicom/1.2.276.0.7230010.3.1.4.8323329.1407.1517875167.596214.png,/home/dianwen/SIIM_ACR/train/images/1024/mask/1.2.276.0.7230010.3.1.4.8323329.1407.1517875167.596214.png,0.0,0.0,915,991
1.2.276.0.7230010.3.1.4.8323329.1408.1517875167.603076.png,292388,{},1,0,"{""name"":""rect"",""x"":70,""y"":105,""width"":805,""height"":794}",{},794,rect,805,70,105,/home/dianwen/SIIM_ACR/train/images/1024/dicom/1.2.276.0.7230010.3.1.4.8323329.1408.1517875167.603076.png,/home/dianwen/SIIM_ACR/train/images/1024/mask/1.2.276.0.7230010.3.1.4.8323329.1408.1517875167.603076.png,0.0,0.0,899,875
1.2.276.0.7230010.3.1.4.8323329.1409.1517875167.603819.png,456981,{},1,0,"{""name"":""rect"",""x"":60,""y"":81,""width"":920,""height"":923}",{},923,rect,920,60,81,/home/dianwen/SIIM_ACR/train/images/1024/dicom/1.2.276.0.7230010.3.1.4.8323329.1409.1517875167.603819.png,/home/dianwen/SIIM_ACR/train/images/1024/mask/1.2.276.0.7230010.3.1.4.8323329.1409.1517875167.603819.png,0.0,0.0,1004,980
1.2.276.0.7230010.3.1.4.8323329.1410.1517875167.621712.png,433087,{},1,0,"{""name"":""rect"",""x"":131,""y"":110,""width"":796,""height"":740}",{},740,rect,796,131,110,/home/dianwen/SIIM_ACR/train/images/1024/dicom/1.2.276.0.7230010.3.1.4.8323329.1410.1517875167.621712.png,/home/dianwen/SIIM_ACR/train/images/1024/mask/1.2.276.0.7230010.3.1.4.8323329.1410.1517875167.621712.png,0.0,0.0,850,927
1.2.276.0.7230010.3.1.4.8323329.1411.1517875167.627303.png,359502,{},1,0,"{""name"":""rect"",""x"":146,""y"":88,""width"":677,""height"":689}",{},689,rect,677,146,88,/home/dianwen/SIIM_ACR/train/images/1024/dicom/1.2.276.0.7230010.3.1.4.8323329.1411.1517875167.627303.png,/home/dianwen/SIIM_ACR/train/images/1024/mask/1.2.276.0.7230010.3.1.4.8323329.1411.1517875167.627303.png,0.0,0.0,777,823
1.2.276.0.7230010.3.1.4.8323329.1412.1517875167.630975.png,464579,{},1,0,"{""name"":""rect"",""x"":81,""y"":119,""width"":840,""height"":805}",{},805,rect,840,81,119,/home/dianwen/SIIM_ACR/train/images/1024/dicom/1.2.276.0.7230010.3.1.4.8323329.1412.1517875167.630975.png,/home/dianwen/SIIM_ACR/train/images/1024/mask/1.2.276.0.7230010.3.1.4.8323329.1412.1517875167.630975.png,0.0,0.0,924,921
1.2.276.0.7230010.3.1.4.8323329.1413.1517875167.641430.png,320744,{},1,0,"{""name"":""rect"",""x"":32,""y"":169,""width"":830,""height"":849}",{},849,rect,830,32,169,/home/dianwen/SIIM_ACR/train/images/1024/dicom/1.2.276.0.7230010.3.1.4.8323329.1413.1517875167.641430.png,/home/dianwen/SIIM_ACR/train/images/1024/mask/1.2.276.0.7230010.3.1.4.8323329.1413.1517875167.641430.png,0.0,0.0,1018,862
1.2.276.0.7230010.3.1.4.8323329.1414.1517875167.654443.png,457609,{},1,0,"{""name"":""rect"",""x"":91,""y"":77,""width"":756,""height"":873}",{},873,rect,756,91,77,/home/dianwen/SIIM_ACR/train/images/1024/dicom/1.2.276.0.7230010.3.1.4.8323329.1414.1517875167.654443.png,/home/dianwen/SIIM_ACR/train/images/1024/mask/1.2.276.0.7230010.3.1.4.8323329.1414.1517875167.654443.png,0.005055427551269531,1.0,950,847
1.2.276.0.7230010.3.1.4.8323329.1415.1517875167.650493.png,445949,{},1,0,"{""name"":""rect"",""x"":26,""y"":121,""width"":923,""height"":889}",{},889,rect,923,26,121,/home/dianwen/SIIM_ACR/train/images/1024/dicom/1.2.276.0.7230010.3.1.4.8323329.1415.1517875167.650493.png,/home/dianwen/SIIM_ACR/train/images/1024/mask/1.2.276.0.7230010.3.1.4.8323329.1415.1517875167.650493.png,0.0,0.0,1010,949
1.2.276.0.7230010.3.1.4.8323329.1417.1517875167.659001.png,434913,{},1,0,"{""name"":""rect"",""x"":176,""y"":84,""width"":727,""height"":743}",{},743,rect,727,176,84,/home/dianwen/SIIM_ACR/train/images/1024/dicom/1.2.276.0.7230010.3.1.4.8323329.1417.1517875167.659001.png,/home/dianwen/SIIM_ACR/train/images/1024/mask/1.2.276.0.7230010.3.1.4.8323329.1417.1517875167.659001.png,0.005519866943359375,1.0,827,903
1.2.276.0.7230010.3.1.4.8323329.1418.1517875167.680760.png,421566,{},1,0,"{""name"":""rect"",""x"":119,""y"":86,""width"":746,""height"":840}",{},840,rect,746,119,86,/home/dianwen/SIIM_ACR/train/images/1024/dicom/1.2.276.0.7230010.3.1.4.8323329.1418.1517875167.680760.png,/home/dianwen/SIIM_ACR/train/images/1024/mask/1.2.276.0.7230010.3.1.4.8323329.1418.1517875167.680760.png,0.0,0.0,926,865
1.2.276.0.7230010.3.1.4.8323329.1419.1517875167.678007.png,426732,{},1,0,"{""name"":""rect"",""x"":101,""y"":96,""width"":848,""height"":698}",{},698,rect,848,101,96,/home/dianwen/SIIM_ACR/train/images/1024/dicom/1.2.276.0.7230010.3.1.4.8323329.1419.1517875167.678007.png,/home/dianwen/SIIM_ACR/train/images/1024/mask/1.2.276.0.7230010.3.1.4.8323329.1419.1517875167.678007.png,0.0,0.0,794,949
1.2.276.0.7230010.3.1.4.8323329.1420.1517875167.677328.png,369175,{},1,0,"{""name"":""rect"",""x"":6,""y"":54,""width"":923,""height"":822}",{},822,rect,923,6,54,/home/dianwen/SIIM_ACR/train/images/1024/dicom/1.2.276.0.7230010.3.1.4.8323329.1420.1517875167.677328.png,/home/dianwen/SIIM_ACR/train/images/1024/mask/1.2.276.0.7230010.3.1.4.8323329.1420.1517875167.677328.png,0.0074863433837890625,1.0,876,929
1.2.276.0.7230010.3.1.4.8323329.1421.1517875167.689908.png,315266,{},1,0,"{""name"":""rect"",""x"":108,""y"":160,""width"":805,""height"":701}",{},701,rect,805,108,160,/home/dianwen/SIIM_ACR/train/images/1024/dicom/1.2.276.0.7230010.3.1.4.8323329.1421.1517875167.689908.png,/home/dianwen/SIIM_ACR/train/images/1024/mask/1.2.276.0.7230010.3.1.4.8323329.1421.1517875167.689908.png,0.0,0.0,861,913
1.2.276.0.7230010.3.1.4.8323329.1422.1517875167.693662.png,332984,{},1,0,"{""name"":""rect"",""x"":125,""y"":81,""width"":813,""height"":875}",{},875,rect,813,125,81,/home/dianwen/SIIM_ACR/train/images/1024/dicom/1.2.276.0.7230010.3.1.4.8323329.1422.1517875167.693662.png,/home/dianwen/SIIM_ACR/train/images/1024/mask/1.2.276.0.7230010.3.1.4.8323329.1422.1517875167.693662.png,0.0,0.0,956,938
1.2.276.0.7230010.3.1.4.8323329.1423.1517875167.682587.png,294246,{},1,0,"{""name"":""rect"",""x"":235,""y"":47,""width"":788,""height"":759}",{},759,rect,788,235,47,/home/dianwen/SIIM_ACR/train/images/1024/dicom/1.2.276.0.7230010.3.1.4.8323329.1423.1517875167.682587.png,/home/dianwen/SIIM_ACR/train/images/1024/mask/1.2.276.0.7230010.3.1.4.8323329.1423.1517875167.682587.png,0.0,0.0,806,1023
1.2.276.0.7230010.3.1.4.8323329.1424.1517875167.710669.png,396324,{},1,0,"{""name"":""rect"",""x"":113,""y"":47,""width"":720,""height"":716}",{},716,rect,720,113,47,/home/dianwen/SIIM_ACR/train/images/1024/dicom/1.2.276.0.7230010.3.1.4.8323329.1424.1517875167.710669.png,/home/dianwen/SIIM_ACR/train/images/1024/mask/1.2.276.0.7230010.3.1.4.8323329.1424.1517875167.710669.png,0.009016990661621094,1.0,763,833
1.2.276.0.7230010.3.1.4.8323329.1425.1517875167.704756.png,421022,{},1,0,"{""name"":""rect"",""x"":140,""y"":72,""width"":783,""height"":638}",{},638,rect,783,140,72,/home/dianwen/SIIM_ACR/train/images/1024/dicom/1.2.276.0.7230010.3.1.4.8323329.1425.1517875167.704756.png,/home/dianwen/SIIM_ACR/train/images/1024/mask/1.2.276.0.7230010.3.1.4.8323329.1425.1517875167.704756.png,0.003336906433105469,1.0,710,923
1.2.276.0.7230010.3.1.4.8323329.1426.1517875167.704674.png,429840,{},1,0,"{""name"":""rect"",""x"":71,""y"":53,""width"":877,""height"":783}",{},783,rect,877,71,53,/home/dianwen/SIIM_ACR/train/images/1024/dicom/1.2.276.0.7230010.3.1.4.8323329.1426.1517875167.704674.png,/home/dianwen/SIIM_ACR/train/images/1024/mask/1.2.276.0.7230010.3.1.4.8323329.1426.1517875167.704674.png,0.0,0.0,836,948
1.2.276.0.7230010.3.1.4.8323329.1427.1517875167.723581.png,345448,{},1,0,"{""name"":""rect"",""x"":117,""y"":113,""width"":881,""height"":911}",{},911,rect,881,117,113,/home/dianwen/SIIM_ACR/train/images/1024/dicom/1.2.276.0.7230010.3.1.4.8323329.1427.1517875167.723581.png,/home/dianwen/SIIM_ACR/train/images/1024/mask/1.2.276.0.7230010.3.1.4.8323329.1427.1517875167.723581.png,0.025890449061989784,1.0,1024,998
1.2.276.0.7230010.3.1.4.8323329.1428.1517875167.716914.png,421243,{},1,0,"{""name"":""rect"",""x"":163,""y"":162,""width"":630,""height"":575}",{},575,rect,630,163,162,/home/dianwen/SIIM_ACR/train/images/1024/dicom/1.2.276.0.7230010.3.1.4.8323329.1428.1517875167.716914.png,/home/dianwen/SIIM_ACR/train/images/1024/mask/1.2.276.0.7230010.3.1.4.8323329.1428.1517875167.716914.png,0.0,0.0,737,793
1.2.276.0.7230010.3.1.4.8323329.1429.1517875167.715096.png,324016,{},1,0,"{""name"":""rect"",""x"":40,""y"":99,""width"":840,""height"":790}",{},790,rect,840,40,99,/home/dianwen/SIIM_ACR/train/images/1024/dicom/1.2.276.0.7230010.3.1.4.8323329.1429.1517875167.715096.png,/home/dianwen/SIIM_ACR/train/images/1024/mask/1.2.276.0.7230010.3.1.4.8323329.1429.1517875167.715096.png,0.0,0.0,889,880
1.2.276.0.7230010.3.1.4.8323329.1430.1517875167.721954.png,363713,{},1,0,"{""name"":""rect"",""x"":125,""y"":159,""width"":775,""height"":762}",{},762,rect,775,125,159,/home/dianwen/SIIM_ACR/train/images/1024/dicom/1.2.276.0.7230010.3.1.4.8323329.1430.1517875167.721954.png,/home/dianwen/SIIM_ACR/train/images/1024/mask/1.2.276.0.7230010.3.1.4.8323329.1430.1517875167.721954.png,0.0,0.0,921,900
1.2.276.0.7230010.3.1.4.8323329.1431.1517875167.734968.png,369401,{},1,0,"{""name"":""rect"",""x"":152,""y"":109,""width"":687,""height"":755}",{},755,rect,687,152,109,/home/dianwen/SIIM_ACR/train/images/1024/dicom/1.2.276.0.7230010.3.1.4.8323329.1431.1517875167.734968.png,/home/dianwen/SIIM_ACR/train/images/1024/mask/1.2.276.0.7230010.3.1.4.8323329.1431.1517875167.734968.png,0.0,0.0,864,839
1.2.276.0.7230010.3.1.4.8323329.1432.1517875167.741209.png,402902,{},1,0,"{""name"":""rect"",""x"":187,""y"":62,""width"":681,""height"":632}",{},632,rect,681,187,62,/home/dianwen/SIIM_ACR/train/images/1024/dicom/1.2.276.0.7230010.3.1.4.8323329.1432.1517875167.741209.png,/home/dianwen/SIIM_ACR/train/images/1024/mask/1.2.276.0.7230010.3.1.4.8323329.1432.1517875167.741209.png,0.0,0.0,694,868
1.2.276.0.7230010.3.1.4.8323329.1433.1517875167.751820.png,414989,{},1,0,"{""name"":""rect"",""x"":164,""y"":11,""width"":727,""height"":731}",{},731,rect,727,164,11,/home/dianwen/SIIM_ACR/train/images/1024/dicom/1.2.276.0.7230010.3.1.4.8323329.1433.1517875167.751820.png,/home/dianwen/SIIM_ACR/train/images/1024/mask/1.2.276.0.7230010.3.1.4.8323329.1433.1517875167.751820.png,0.0,0.0,742,891
1.2.276.0.7230010.3.1.4.8323329.1434.1517875167.749769.png,363533,{},1,0,"{""name"":""rect"",""x"":132,""y"":131,""width"":701,""height"":677}",{},677,rect,701,132,131,/home/dianwen/SIIM_ACR/train/images/1024/dicom/1.2.276.0.7230010.3.1.4.8323329.1434.1517875167.749769.png,/home/dianwen/SIIM_ACR/train/images/1024/mask/1.2.276.0.7230010.3.1.4.8323329.1434.1517875167.749769.png,0.0,0.0,808,833
1.2.276.0.7230010.3.1.4.8323329.1435.1517875167.764078.png,433539,{},1,0,"{""name"":""rect"",""x"":89,""y"":107,""width"":880,""height"":716}",{},716,rect,880,89,107,/home/dianwen/SIIM_ACR/train/images/1024/dicom/1.2.276.0.7230010.3.1.4.8323329.1435.1517875167.764078.png,/home/dianwen/SIIM_ACR/train/images/1024/mask/1.2.276.0.7230010.3.1.4.8323329.1435.1517875167.764078.png,0.0,0.0,823,969
1.2.276.0.7230010.3.1.4.8323329.1436.1517875167.763796.png,414154,{},1,0,"{""name"":""rect"",""x"":152,""y"":172,""width"":752,""height"":630}",{},630,rect,752,152,172,/home/dianwen/SIIM_ACR/train/images/1024/dicom/1.2.276.0.7230010.3.1.4.8323329.1436.1517875167.763796.png,/home/dianwen/SIIM_ACR/train/images/1024/mask/1.2.276.0.7230010.3.1.4.8323329.1436.1517875167.763796.png,0.0,0.0,802,904
1.2.276.0.7230010.3.1.4.8323329.1437.1517875167.769573.png,460702,{},1,0,"{""name"":""rect"",""x"":180,""y"":91,""width"":817,""height"":929}",{},929,rect,817,180,91,/home/dianwen/SIIM_ACR/train/images/1024/dicom/1.2.276.0.7230010.3.1.4.8323329.1437.1517875167.769573.png,/home/dianwen/SIIM_ACR/train/images/1024/mask/1.2.276.0.7230010.3.1.4.8323329.1437.1517875167.769573.png,0.0,0.0,1020,997
1.2.276.0.7230010.3.1.4.8323329.1438.1517875167.777784.png,379165,{},1,0,"{""name"":""rect"",""x"":65,""y"":63,""width"":816,""height"":883}",{},883,rect,816,65,63,/home/dianwen/SIIM_ACR/train/images/1024/dicom/1.2.276.0.7230010.3.1.4.8323329.1438.1517875167.777784.png,/home/dianwen/SIIM_ACR/train/images/1024/mask/1.2.276.0.7230010.3.1.4.8323329.1438.1517875167.777784.png,0.0,0.0,946,881
1.2.276.0.7230010.3.1.4.8323329.1439.1517875167.780288.png,294066,{},1,0,"{""name"":""rect"",""x"":252,""y"":147,""width"":744,""height"":765}",{},765,rect,744,252,147,/home/dianwen/SIIM_ACR/train/images/1024/dicom/1.2.276.0.7230010.3.1.4.8323329.1439.1517875167.780288.png,/home/dianwen/SIIM_ACR/train/images/1024/mask/1.2.276.0.7230010.3.1.4.8323329.1439.1517875167.780288.png,0.0,0.0,912,996
1.2.276.0.7230010.3.1.4.8323329.1440.1517875167.790515.png,411244,{},1,0,"{""name"":""rect"",""x"":114,""y"":90,""width"":720,""height"":856}",{},856,rect,720,114,90,/home/dianwen/SIIM_ACR/train/images/1024/dicom/1.2.276.0.7230010.3.1.4.8323329.1440.1517875167.790515.png,/home/dianwen/SIIM_ACR/train/images/1024/mask/1.2.276.0.7230010.3.1.4.8323329.1440.1517875167.790515.png,0.0,0.0,946,834
1.2.276.0.7230010.3.1.4.8323329.1441.1517875167.793636.png,419684,{},1,0,"{""name"":""rect"",""x"":54,""y"":91,""width"":914,""height"":753}",{},753,rect,914,54,91,/home/dianwen/SIIM_ACR/train/images/1024/dicom/1.2.276.0.7230010.3.1.4.8323329.1441.1517875167.793636.png,/home/dianwen/SIIM_ACR/train/images/1024/mask/1.2.276.0.7230010.3.1.4.8323329.1441.1517875167.793636.png,0.0,0.0,844,968
1.2.276.0.7230010.3.1.4.8323329.1442.1517875167.804469.png,448478,{},1,0,"{""name"":""rect"",""x"":65,""y"":30,""width"":790,""height"":658}",{},658,rect,790,65,30,/home/dianwen/SIIM_ACR/train/images/1024/dicom/1.2.276.0.7230010.3.1.4.8323329.1442.1517875167.804469.png,/home/dianwen/SIIM_ACR/train/images/1024/mask/1.2.276.0.7230010.3.1.4.8323329.1442.1517875167.804469.png,0.0,0.0,688,855
1.2.276.0.7230010.3.1.4.8323329.1443.1517875167.807763.png,252832,{},1,0,"{""name"":""rect"",""x"":93,""y"":212,""width"":699,""height"":564}",{},564,rect,699,93,212,/home/dianwen/SIIM_ACR/train/images/1024/dicom/1.2.276.0.7230010.3.1.4.8323329.1443.1517875167.807763.png,/home/dianwen/SIIM_ACR/train/images/1024/mask/1.2.276.0.7230010.3.1.4.8323329.1443.1517875167.807763.png,0.0,0.0,776,792
1.2.276.0.7230010.3.1.4.8323329.1444.1517875167.819390.png,464002,{},1,0,"{""name"":""rect"",""x"":35,""y"":117,""width"":961,""height"":883}",{},883,rect,961,35,117,/home/dianwen/SIIM_ACR/train/images/1024/dicom/1.2.276.0.7230010.3.1.4.8323329.1444.1517875167.819390.png,/home/dianwen/SIIM_ACR/train/images/1024/mask/1.2.276.0.7230010.3.1.4.8323329.1444.1517875167.819390.png,0.0,0.0,1000,996
1.2.276.0.7230010.3.1.4.8323329.1445.1517875167.832507.png,391967,{},1,0,"{""name"":""rect"",""x"":238,""y"":172,""width"":638,""height"":836}",{},836,rect,638,238,172,/home/dianwen/SIIM_ACR/train/images/1024/dicom/1.2.276.0.7230010.3.1.4.8323329.1445.1517875167.832507.png,/home/dianwen/SIIM_ACR/train/images/1024/mask/1.2.276.0.7230010.3.1.4.8323329.1445.1517875167.832507.png,0.0,0.0,1008,876
1.2.276.0.7230010.3.1.4.8323329.1447.1517875167.838333.png,432462,{},1,0,"{""name"":""rect"",""x"":97,""y"":93,""width"":835,""height"":665}",{},665,rect,835,97,93,/home/dianwen/SIIM_ACR/train/images/1024/dicom/1.2.276.0.7230010.3.1.4.8323329.1447.1517875167.838333.png,/home/dianwen/SIIM_ACR/train/images/1024/mask/1.2.276.0.7230010.3.1.4.8323329.1447.1517875167.838333.png,0.0,0.0,758,932
1.2.276.0.7230010.3.1.4.8323329.1448.1517875167.844062.png,378744,{},1,0,"{""name"":""rect"",""x"":153,""y"":115,""width"":743,""height"":820}",{},820,rect,743,153,115,/home/dianwen/SIIM_ACR/train/images/1024/dicom/1.2.276.0.7230010.3.1.4.8323329.1448.1517875167.844062.png,/home/dianwen/SIIM_ACR/train/images/1024/mask/1.2.276.0.7230010.3.1.4.8323329.1448.1517875167.844062.png,0.0,0.0,935,896
1.2.276.0.7230010.3.1.4.8323329.1449.1517875167.851384.png,400739,{},1,0,"{""name"":""rect"",""x"":129,""y"":68,""width"":850,""height"":910}",{},910,rect,850,129,68,/home/dianwen/SIIM_ACR/train/images/1024/dicom/1.2.276.0.7230010.3.1.4.8323329.1449.1517875167.851384.png,/home/dianwen/SIIM_ACR/train/images/1024/mask/1.2.276.0.7230010.3.1.4.8323329.1449.1517875167.851384.png,0.0,0.0,978,979
1.2.276.0.7230010.3.1.4.8323329.1450.1517875167.854451.png,322374,{},1,0,"{""name"":""rect"",""x"":78,""y"":137,""width"":898,""height"":862}",{},862,rect,898,78,137,/home/dianwen/SIIM_ACR/train/images/1024/dicom/1.2.276.0.7230010.3.1.4.8323329.1450.1517875167.854451.png,/home/dianwen/SIIM_ACR/train/images/1024/mask/1.2.276.0.7230010.3.1.4.8323329.1450.1517875167.854451.png,0.0017242431640625,1.0,999,976
1.2.276.0.7230010.3.1.4.8323329.1451.1517875167.859741.png,408571,{},1,0,"{""name"":""rect"",""x"":106,""y"":163,""width"":768,""height"":753}",{},753,rect,768,106,163,/home/dianwen/SIIM_ACR/train/images/1024/dicom/1.2.276.0.7230010.3.1.4.8323329.1451.1517875167.859741.png,/home/dianwen/SIIM_ACR/train/images/1024/mask/1.2.276.0.7230010.3.1.4.8323329.1451.1517875167.859741.png,0.0,0.0,916,874
1.2.276.0.7230010.3.1.4.8323329.1452.1517875167.861316.png,437914,{},1,0,"{""name"":""rect"",""x"":2,""y"":55,""width"":961,""height"":969}",{},969,rect,961,2,55,/home/dianwen/SIIM_ACR/train/images/1024/dicom/1.2.276.0.7230010.3.1.4.8323329.1452.1517875167.861316.png,/home/dianwen/SIIM_ACR/train/images/1024/mask/1.2.276.0.7230010.3.1.4.8323329.1452.1517875167.861316.png,0.0,0.0,1024,963
1.2.276.0.7230010.3.1.4.8323329.1453.1517875167.861719.png,417948,{},1,0,"{""name"":""rect"",""x"":121,""y"":104,""width"":783,""height"":919}",{},919,rect,783,121,104,/home/dianwen/SIIM_ACR/train/images/1024/dicom/1.2.276.0.7230010.3.1.4.8323329.1453.1517875167.861719.png,/home/dianwen/SIIM_ACR/train/images/1024/mask/1.2.276.0.7230010.3.1.4.8323329.1453.1517875167.861719.png,0.0,0.0,1023,904
1.2.276.0.7230010.3.1.4.8323329.1454.1517875167.874231.png,372338,{},1,0,"{""name"":""rect"",""x"":161,""y"":91,""width"":722,""height"":701}",{},701,rect,722,161,91,/home/dianwen/SIIM_ACR/train/images/1024/dicom/1.2.276.0.7230010.3.1.4.8323329.1454.1517875167.874231.png,/home/dianwen/SIIM_ACR/train/images/1024/mask/1.2.276.0.7230010.3.1.4.8323329.1454.1517875167.874231.png,0.0,0.0,792,883
1.2.276.0.7230010.3.1.4.8323329.1455.1517875167.880264.png,374389,{},1,0,"{""name"":""rect"",""x"":107,""y"":203,""width"":788,""height"":704}",{},704,rect,788,107,203,/home/dianwen/SIIM_ACR/train/images/1024/dicom/1.2.276.0.7230010.3.1.4.8323329.1455.1517875167.880264.png,/home/dianwen/SIIM_ACR/train/images/1024/mask/1.2.276.0.7230010.3.1.4.8323329.1455.1517875167.880264.png,0.0,0.0,907,895
1.2.276.0.7230010.3.1.4.8323329.1456.1517875167.888173.png,454183,{},1,0,"{""name"":""rect"",""x"":48,""y"":0,""width"":903,""height"":902}",{},902,rect,903,48,0,/home/dianwen/SIIM_ACR/train/images/1024/dicom/1.2.276.0.7230010.3.1.4.8323329.1456.1517875167.888173.png,/home/dianwen/SIIM_ACR/train/images/1024/mask/1.2.276.0.7230010.3.1.4.8323329.1456.1517875167.888173.png,0.0,0.0,902,951
1.2.276.0.7230010.3.1.4.8323329.1457.1517875167.886880.png,396274,{},1,0,"{""name"":""rect"",""x"":76,""y"":80,""width"":886,""height"":737}",{},737,rect,886,76,80,/home/dianwen/SIIM_ACR/train/images/1024/dicom/1.2.276.0.7230010.3.1.4.8323329.1457.1517875167.886880.png,/home/dianwen/SIIM_ACR/train/images/1024/mask/1.2.276.0.7230010.3.1.4.8323329.1457.1517875167.886880.png,0.0,0.0,817,962
1.2.276.0.7230010.3.1.4.8323329.1458.1517875167.901278.png,442523,{},1,0,"{""name"":""rect"",""x"":5,""y"":3,""width"":1007,""height"":801}",{},801,rect,1007,5,3,/home/dianwen/SIIM_ACR/train/images/1024/dicom/1.2.276.0.7230010.3.1.4.8323329.1458.1517875167.901278.png,/home/dianwen/SIIM_ACR/train/images/1024/mask/1.2.276.0.7230010.3.1.4.8323329.1458.1517875167.901278.png,0.01911234296858311,1.0,804,1012
1.2.276.0.7230010.3.1.4.8323329.1459.1517875167.899248.png,396009,{},1,0,"{""name"":""rect"",""x"":108,""y"":57,""width"":819,""height"":743}",{},743,rect,819,108,57,/home/dianwen/SIIM_ACR/train/images/1024/dicom/1.2.276.0.7230010.3.1.4.8323329.1459.1517875167.899248.png,/home/dianwen/SIIM_ACR/train/images/1024/mask/1.2.276.0.7230010.3.1.4.8323329.1459.1517875167.899248.png,0.0,0.0,800,927
1.2.276.0.7230010.3.1.4.8323329.1460.1517875167.903103.png,403443,{},1,0,"{""name"":""rect"",""x"":103,""y"":60,""width"":771,""height"":805}",{},805,rect,771,103,60,/home/dianwen/SIIM_ACR/train/images/1024/dicom/1.2.276.0.7230010.3.1.4.8323329.1460.1517875167.903103.png,/home/dianwen/SIIM_ACR/train/images/1024/mask/1.2.276.0.7230010.3.1.4.8323329.1460.1517875167.903103.png,0.0048980712890625,1.0,865,874
1.2.276.0.7230010.3.1.4.8323329.1461.1517875167.903360.png,441354,{},1,0,"{""name"":""rect"",""x"":56,""y"":42,""width"":910,""height"":978}",{},978,rect,910,56,42,/home/dianwen/SIIM_ACR/train/images/1024/dicom/1.2.276.0.7230010.3.1.4.8323329.1461.1517875167.903360.png,/home/dianwen/SIIM_ACR/train/images/1024/mask/1.2.276.0.7230010.3.1.4.8323329.1461.1517875167.903360.png,0.02289104461669922,1.0,1020,966
1.2.276.0.7230010.3.1.4.8323329.1462.1517875167.913346.png,385174,{},1,0,"{""name"":""rect"",""x"":104,""y"":109,""width"":737,""height"":762}",{},762,rect,737,104,109,/home/dianwen/SIIM_ACR/train/images/1024/dicom/1.2.276.0.7230010.3.1.4.8323329.1462.1517875167.913346.png,/home/dianwen/SIIM_ACR/train/images/1024/mask/1.2.276.0.7230010.3.1.4.8323329.1462.1517875167.913346.png,0.0,0.0,871,841
1.2.276.0.7230010.3.1.4.8323329.1463.1517875167.925674.png,362883,{},1,0,"{""name"":""rect"",""x"":40,""y"":57,""width"":784,""height"":847}",{},847,rect,784,40,57,/home/dianwen/SIIM_ACR/train/images/1024/dicom/1.2.276.0.7230010.3.1.4.8323329.1463.1517875167.925674.png,/home/dianwen/SIIM_ACR/train/images/1024/mask/1.2.276.0.7230010.3.1.4.8323329.1463.1517875167.925674.png,0.0,0.0,904,824
1.2.276.0.7230010.3.1.4.8323329.1464.1517875167.927281.png,390116,{},1,0,"{""name"":""rect"",""x"":133,""y"":42,""width"":838,""height"":934}",{},934,rect,838,133,42,/home/dianwen/SIIM_ACR/train/images/1024/dicom/1.2.276.0.7230010.3.1.4.8323329.1464.1517875167.927281.png,/home/dianwen/SIIM_ACR/train/images/1024/mask/1.2.276.0.7230010.3.1.4.8323329.1464.1517875167.927281.png,0.0,0.0,976,971
1.2.276.0.7230010.3.1.4.8323329.1465.1517875167.930617.png,390976,{},1,0,"{""name"":""rect"",""x"":96,""y"":171,""width"":859,""height"":726}",{},726,rect,859,96,171,/home/dianwen/SIIM_ACR/train/images/1024/dicom/1.2.276.0.7230010.3.1.4.8323329.1465.1517875167.930617.png,/home/dianwen/SIIM_ACR/train/images/1024/mask/1.2.276.0.7230010.3.1.4.8323329.1465.1517875167.930617.png,0.0,0.0,897,955
1.2.276.0.7230010.3.1.4.8323329.1466.1517875167.941720.png,417053,{},1,0,"{""name"":""rect"",""x"":113,""y"":116,""width"":873,""height"":804}",{},804,rect,873,113,116,/home/dianwen/SIIM_ACR/train/images/1024/dicom/1.2.276.0.7230010.3.1.4.8323329.1466.1517875167.941720.png,/home/dianwen/SIIM_ACR/train/images/1024/mask/1.2.276.0.7230010.3.1.4.8323329.1466.1517875167.941720.png,0.0,0.0,920,986
1.2.276.0.7230010.3.1.4.8323329.1467.1517875167.949678.png,336960,{},1,0,"{""name"":""rect"",""x"":160,""y"":72,""width"":770,""height"":879}",{},879,rect,770,160,72,/home/dianwen/SIIM_ACR/train/images/1024/dicom/1.2.276.0.7230010.3.1.4.8323329.1467.1517875167.949678.png,/home/dianwen/SIIM_ACR/train/images/1024/mask/1.2.276.0.7230010.3.1.4.8323329.1467.1517875167.949678.png,0.0,0.0,951,930
1.2.276.0.7230010.3.1.4.8323329.1468.1517875167.947063.png,304228,{},1,0,"{""name"":""rect"",""x"":153,""y"":77,""width"":739,""height"":895}",{},895,rect,739,153,77,/home/dianwen/SIIM_ACR/train/images/1024/dicom/1.2.276.0.7230010.3.1.4.8323329.1468.1517875167.947063.png,/home/dianwen/SIIM_ACR/train/images/1024/mask/1.2.276.0.7230010.3.1.4.8323329.1468.1517875167.947063.png,0.0,0.0,972,892
1.2.276.0.7230010.3.1.4.8323329.1469.1517875167.950672.png,370262,{},1,0,"{""name"":""rect"",""x"":185,""y"":128,""width"":735,""height"":819}",{},819,rect,735,185,128,/home/dianwen/SIIM_ACR/train/images/1024/dicom/1.2.276.0.7230010.3.1.4.8323329.1469.1517875167.950672.png,/home/dianwen/SIIM_ACR/train/images/1024/mask/1.2.276.0.7230010.3.1.4.8323329.1469.1517875167.950672.png,0.0,0.0,947,920
1.2.276.0.7230010.3.1.4.8323329.1470.1517875167.949686.png,426864,{},1,0,"{""name"":""rect"",""x"":120,""y"":120,""width"":807,""height"":897}",{},897,rect,807,120,120,/home/dianwen/SIIM_ACR/train/images/1024/dicom/1.2.276.0.7230010.3.1.4.8323329.1470.1517875167.949686.png,/home/dianwen/SIIM_ACR/train/images/1024/mask/1.2.276.0.7230010.3.1.4.8323329.1470.1517875167.949686.png,0.0,0.0,1017,927
1.2.276.0.7230010.3.1.4.8323329.1471.1517875167.963030.png,447171,{},1,0,"{""name"":""rect"",""x"":25,""y"":116,""width"":873,""height"":880}",{},880,rect,873,25,116,/home/dianwen/SIIM_ACR/train/images/1024/dicom/1.2.276.0.7230010.3.1.4.8323329.1471.1517875167.963030.png,/home/dianwen/SIIM_ACR/train/images/1024/mask/1.2.276.0.7230010.3.1.4.8323329.1471.1517875167.963030.png,0.0,0.0,996,898
1.2.276.0.7230010.3.1.4.8323329.1472.1517875167.969356.png,282811,{},1,0,"{""name"":""rect"",""x"":42,""y"":60,""width"":792,""height"":883}",{},883,rect,792,42,60,/home/dianwen/SIIM_ACR/train/images/1024/dicom/1.2.276.0.7230010.3.1.4.8323329.1472.1517875167.969356.png,/home/dianwen/SIIM_ACR/train/images/1024/mask/1.2.276.0.7230010.3.1.4.8323329.1472.1517875167.969356.png,0.0,0.0,943,834
1.2.276.0.7230010.3.1.4.8323329.1473.1517875167.969356.png,435201,{},1,0,"{""name"":""rect"",""x"":62,""y"":101,""width"":946,""height"":792}",{},792,rect,946,62,101,/home/dianwen/SIIM_ACR/train/images/1024/dicom/1.2.276.0.7230010.3.1.4.8323329.1473.1517875167.969356.png,/home/dianwen/SIIM_ACR/train/images/1024/mask/1.2.276.0.7230010.3.1.4.8323329.1473.1517875167.969356.png,0.0,0.0,893,1008
1.2.276.0.7230010.3.1.4.8323329.1474.1517875167.972888.png,433634,{},1,0,"{""name"":""rect"",""x"":81,""y"":59,""width"":814,""height"":911}",{},911,rect,814,81,59,/home/dianwen/SIIM_ACR/train/images/1024/dicom/1.2.276.0.7230010.3.1.4.8323329.1474.1517875167.972888.png,/home/dianwen/SIIM_ACR/train/images/1024/mask/1.2.276.0.7230010.3.1.4.8323329.1474.1517875167.972888.png,0.0,0.0,970,895
1.2.276.0.7230010.3.1.4.8323329.1475.1517875167.980123.png,434634,{},1,0,"{""name"":""rect"",""x"":116,""y"":98,""width"":849,""height"":923}",{},923,rect,849,116,98,/home/dianwen/SIIM_ACR/train/images/1024/dicom/1.2.276.0.7230010.3.1.4.8323329.1475.1517875167.980123.png,/home/dianwen/SIIM_ACR/train/images/1024/mask/1.2.276.0.7230010.3.1.4.8323329.1475.1517875167.980123.png,0.0,0.0,1021,965
1.2.276.0.7230010.3.1.4.8323329.1476.1517875167.978913.png,426527,{},1,0,"{""name"":""rect"",""x"":110,""y"":121,""width"":778,""height"":899}",{},899,rect,778,110,121,/home/dianwen/SIIM_ACR/train/images/1024/dicom/1.2.276.0.7230010.3.1.4.8323329.1476.1517875167.978913.png,/home/dianwen/SIIM_ACR/train/images/1024/mask/1.2.276.0.7230010.3.1.4.8323329.1476.1517875167.978913.png,0.0,0.0,1020,888
1.2.276.0.7230010.3.1.4.8323329.1477.1517875167.996635.png,401796,{},1,0,"{""name"":""rect"",""x"":215,""y"":120,""width"":669,""height"":660}",{},660,rect,669,215,120,/home/dianwen/SIIM_ACR/train/images/1024/dicom/1.2.276.0.7230010.3.1.4.8323329.1477.1517875167.996635.png,/home/dianwen/SIIM_ACR/train/images/1024/mask/1.2.276.0.7230010.3.1.4.8323329.1477.1517875167.996635.png,0.0030612945556640625,1.0,780,884
1.2.276.0.7230010.3.1.4.8323329.1478.1517875167.994510.png,398631,{},1,0,"{""name"":""rect"",""x"":201,""y"":159,""width"":726,""height"":752}",{},752,rect,726,201,159,/home/dianwen/SIIM_ACR/train/images/1024/dicom/1.2.276.0.7230010.3.1.4.8323329.1478.1517875167.994510.png,/home/dianwen/SIIM_ACR/train/images/1024/mask/1.2.276.0.7230010.3.1.4.8323329.1478.1517875167.994510.png,0.025912700220942497,1.0,911,927
1.2.276.0.7230010.3.1.4.8323329.1479.1517875167.1458.png,348613,{},1,0,"{""name"":""rect"",""x"":137,""y"":177,""width"":767,""height"":747}",{},747,rect,767,137,177,/home/dianwen/SIIM_ACR/train/images/1024/dicom/1.2.276.0.7230010.3.1.4.8323329.1479.1517875167.1458.png,/home/dianwen/SIIM_ACR/train/images/1024/mask/1.2.276.0.7230010.3.1.4.8323329.1479.1517875167.1458.png,0.0,0.0,924,904
1.2.276.0.7230010.3.1.4.8323329.1480.1517875168.5210.png,314124,{},1,0,"{""name"":""rect"",""x"":60,""y"":12,""width"":885,""height"":955}",{},955,rect,885,60,12,/home/dianwen/SIIM_ACR/train/images/1024/dicom/1.2.276.0.7230010.3.1.4.8323329.1480.1517875168.5210.png,/home/dianwen/SIIM_ACR/train/images/1024/mask/1.2.276.0.7230010.3.1.4.8323329.1480.1517875168.5210.png,0.0,0.0,967,945
1.2.276.0.7230010.3.1.4.8323329.1481.1517875168.16204.png,427534,{},1,0,"{""name"":""rect"",""x"":108,""y"":97,""width"":837,""height"":758}",{},758,rect,837,108,97,/home/dianwen/SIIM_ACR/train/images/1024/dicom/1.2.276.0.7230010.3.1.4.8323329.1481.1517875168.16204.png,/home/dianwen/SIIM_ACR/train/images/1024/mask/1.2.276.0.7230010.3.1.4.8323329.1481.1517875168.16204.png,0.0,0.0,855,945
1.2.276.0.7230010.3.1.4.8323329.1482.1517875168.22269.png,335706,{},1,0,"{""name"":""rect"",""x"":108,""y"":13,""width"":729,""height"":796}",{},796,rect,729,108,13,/home/dianwen/SIIM_ACR/train/images/1024/dicom/1.2.276.0.7230010.3.1.4.8323329.1482.1517875168.22269.png,/home/dianwen/SIIM_ACR/train/images/1024/mask/1.2.276.0.7230010.3.1.4.8323329.1482.1517875168.22269.png,0.0,0.0,809,837
1.2.276.0.7230010.3.1.4.8323329.1483.1517875168.34732.png,416457,{},1,0,"{""name"":""rect"",""x"":77,""y"":24,""width"":850,""height"":925}",{},925,rect,850,77,24,/home/dianwen/SIIM_ACR/train/images/1024/dicom/1.2.276.0.7230010.3.1.4.8323329.1483.1517875168.34732.png,/home/dianwen/SIIM_ACR/train/images/1024/mask/1.2.276.0.7230010.3.1.4.8323329.1483.1517875168.34732.png,0.0,0.0,949,927
1.2.276.0.7230010.3.1.4.8323329.1484.1517875168.37882.png,388487,{},1,0,"{""name"":""rect"",""x"":33,""y"":129,""width"":927,""height"":727}",{},727,rect,927,33,129,/home/dianwen/SIIM_ACR/train/images/1024/dicom/1.2.276.0.7230010.3.1.4.8323329.1484.1517875168.37882.png,/home/dianwen/SIIM_ACR/train/images/1024/mask/1.2.276.0.7230010.3.1.4.8323329.1484.1517875168.37882.png,0.0,0.0,856,960
1.2.276.0.7230010.3.1.4.8323329.1485.1517875168.41670.png,408615,{},1,0,"{""name"":""rect"",""x"":20,""y"":134,""width"":842,""height"":764}",{},764,rect,842,20,134,/home/dianwen/SIIM_ACR/train/images/1024/dicom/1.2.276.0.7230010.3.1.4.8323329.1485.1517875168.41670.png,/home/dianwen/SIIM_ACR/train/images/1024/mask/1.2.276.0.7230010.3.1.4.8323329.1485.1517875168.41670.png,0.04947280883789063,1.0,898,862
1.2.276.0.7230010.3.1.4.8323329.1486.1517875168.54647.png,415033,{},1,0,"{""name"":""rect"",""x"":127,""y"":101,""width"":765,""height"":916}",{},916,rect,765,127,101,/home/dianwen/SIIM_ACR/train/images/1024/dicom/1.2.276.0.7230010.3.1.4.8323329.1486.1517875168.54647.png,/home/dianwen/SIIM_ACR/train/images/1024/mask/1.2.276.0.7230010.3.1.4.8323329.1486.1517875168.54647.png,0.0,0.0,1017,892
1.2.276.0.7230010.3.1.4.8323329.1487.1517875168.62616.png,440269,{},1,0,"{""name"":""rect"",""x"":4,""y"":77,""width"":908,""height"":658}",{},658,rect,908,4,77,/home/dianwen/SIIM_ACR/train/images/1024/dicom/1.2.276.0.7230010.3.1.4.8323329.1487.1517875168.62616.png,/home/dianwen/SIIM_ACR/train/images/1024/mask/1.2.276.0.7230010.3.1.4.8323329.1487.1517875168.62616.png,0.012937545776367188,1.0,735,912
1.2.276.0.7230010.3.1.4.8323329.1488.1517875168.67618.png,314388,{},1,0,"{""name"":""rect"",""x"":231,""y"":172,""width"":767,""height"":849}",{},849,rect,767,231,172,/home/dianwen/SIIM_ACR/train/images/1024/dicom/1.2.276.0.7230010.3.1.4.8323329.1488.1517875168.67618.png,/home/dianwen/SIIM_ACR/train/images/1024/mask/1.2.276.0.7230010.3.1.4.8323329.1488.1517875168.67618.png,0.0,0.0,1021,998
1.2.276.0.7230010.3.1.4.8323329.1489.1517875168.78420.png,371280,{},1,0,"{""name"":""rect"",""x"":68,""y"":75,""width"":897,""height"":935}",{},935,rect,897,68,75,/home/dianwen/SIIM_ACR/train/images/1024/dicom/1.2.276.0.7230010.3.1.4.8323329.1489.1517875168.78420.png,/home/dianwen/SIIM_ACR/train/images/1024/mask/1.2.276.0.7230010.3.1.4.8323329.1489.1517875168.78420.png,0.0,0.0,1010,965
1.2.276.0.7230010.3.1.4.8323329.1490.1517875168.83680.png,414788,{},1,0,"{""name"":""rect"",""x"":146,""y"":65,""width"":775,""height"":885}",{},885,rect,775,146,65,/home/dianwen/SIIM_ACR/train/images/1024/dicom/1.2.276.0.7230010.3.1.4.8323329.1490.1517875168.83680.png,/home/dianwen/SIIM_ACR/train/images/1024/mask/1.2.276.0.7230010.3.1.4.8323329.1490.1517875168.83680.png,0.0,0.0,950,921
1.2.276.0.7230010.3.1.4.8323329.1491.1517875168.91894.png,435409,{},1,0,"{""name"":""rect"",""x"":97,""y"":107,""width"":786,""height"":817}",{},817,rect,786,97,107,/home/dianwen/SIIM_ACR/train/images/1024/dicom/1.2.276.0.7230010.3.1.4.8323329.1491.1517875168.91894.png,/home/dianwen/SIIM_ACR/train/images/1024/mask/1.2.276.0.7230010.3.1.4.8323329.1491.1517875168.91894.png,0.0,0.0,924,883
1.2.276.0.7230010.3.1.4.8323329.1492.1517875168.93461.png,446702,{},1,0,"{""name"":""rect"",""x"":117,""y"":7,""width"":781,""height"":828}",{},828,rect,781,117,7,/home/dianwen/SIIM_ACR/train/images/1024/dicom/1.2.276.0.7230010.3.1.4.8323329.1492.1517875168.93461.png,/home/dianwen/SIIM_ACR/train/images/1024/mask/1.2.276.0.7230010.3.1.4.8323329.1492.1517875168.93461.png,0.0013360977172851562,1.0,835,898
1.2.276.0.7230010.3.1.4.8323329.1493.1517875168.88718.png,415143,{},1,0,"{""name"":""rect"",""x"":103,""y"":124,""width"":777,""height"":835}",{},835,rect,777,103,124,/home/dianwen/SIIM_ACR/train/images/1024/dicom/1.2.276.0.7230010.3.1.4.8323329.1493.1517875168.88718.png,/home/dianwen/SIIM_ACR/train/images/1024/mask/1.2.276.0.7230010.3.1.4.8323329.1493.1517875168.88718.png,0.0,0.0,959,880
1.2.276.0.7230010.3.1.4.8323329.1494.1517875168.97725.png,306284,{},1,0,"{""name"":""rect"",""x"":43,""y"":160,""width"":885,""height"":757}",{},757,rect,885,43,160,/home/dianwen/SIIM_ACR/train/images/1024/dicom/1.2.276.0.7230010.3.1.4.8323329.1494.1517875168.97725.png,/home/dianwen/SIIM_ACR/train/images/1024/mask/1.2.276.0.7230010.3.1.4.8323329.1494.1517875168.97725.png,0.0,0.0,917,928
1.2.276.0.7230010.3.1.4.8323329.1495.1517875168.105552.png,237480,{},1,0,"{""name"":""rect"",""x"":198,""y"":242,""width"":665,""height"":646}",{},646,rect,665,198,242,/home/dianwen/SIIM_ACR/train/images/1024/dicom/1.2.276.0.7230010.3.1.4.8323329.1495.1517875168.105552.png,/home/dianwen/SIIM_ACR/train/images/1024/mask/1.2.276.0.7230010.3.1.4.8323329.1495.1517875168.105552.png,0.0,0.0,888,863
1.2.276.0.7230010.3.1.4.8323329.1496.1517875168.106827.png,433561,{},1,0,"{""name"":""rect"",""x"":9,""y"":67,""width"":944,""height"":721}",{},721,rect,944,9,67,/home/dianwen/SIIM_ACR/train/images/1024/dicom/1.2.276.0.7230010.3.1.4.8323329.1496.1517875168.106827.png,/home/dianwen/SIIM_ACR/train/images/1024/mask/1.2.276.0.7230010.3.1.4.8323329.1496.1517875168.106827.png,0.0,0.0,788,953
1.2.276.0.7230010.3.1.4.8323329.1497.1517875168.106306.png,432950,{},1,0,"{""name"":""rect"",""x"":79,""y"":17,""width"":847,""height"":734}",{},734,rect,847,79,17,/home/dianwen/SIIM_ACR/train/images/1024/dicom/1.2.276.0.7230010.3.1.4.8323329.1497.1517875168.106306.png,/home/dianwen/SIIM_ACR/train/images/1024/mask/1.2.276.0.7230010.3.1.4.8323329.1497.1517875168.106306.png,0.0,0.0,751,926
1.2.276.0.7230010.3.1.4.8323329.1498.1517875168.123097.png,423204,{},1,0,"{""name"":""rect"",""x"":147,""y"":38,""width"":756,""height"":787}",{},787,rect,756,147,38,/home/dianwen/SIIM_ACR/train/images/1024/dicom/1.2.276.0.7230010.3.1.4.8323329.1498.1517875168.123097.png,/home/dianwen/SIIM_ACR/train/images/1024/mask/1.2.276.0.7230010.3.1.4.8323329.1498.1517875168.123097.png,0.0577961727976799,1.0,825,903
1.2.276.0.7230010.3.1.4.8323329.1499.1517875168.127294.png,408254,{},1,0,"{""name"":""rect"",""x"":13,""y"":143,""width"":755,""height"":638}",{},638,rect,755,13,143,/home/dianwen/SIIM_ACR/train/images/1024/dicom/1.2.276.0.7230010.3.1.4.8323329.1499.1517875168.127294.png,/home/dianwen/SIIM_ACR/train/images/1024/mask/1.2.276.0.7230010.3.1.4.8323329.1499.1517875168.127294.png,0.0,0.0,781,768
1.2.276.0.7230010.3.1.4.8323329.1500.1517875168.126056.png,396459,{},1,0,"{""name"":""rect"",""x"":121,""y"":75,""width"":641,""height"":667}",{},667,rect,641,121,75,/home/dianwen/SIIM_ACR/train/images/1024/dicom/1.2.276.0.7230010.3.1.4.8323329.1500.1517875168.126056.png,/home/dianwen/SIIM_ACR/train/images/1024/mask/1.2.276.0.7230010.3.1.4.8323329.1500.1517875168.126056.png,0.0,0.0,742,762
1.2.276.0.7230010.3.1.4.8323329.1501.1517875168.127863.png,397295,{},1,0,"{""name"":""rect"",""x"":103,""y"":142,""width"":777,""height"":687}",{},687,rect,777,103,142,/home/dianwen/SIIM_ACR/train/images/1024/dicom/1.2.276.0.7230010.3.1.4.8323329.1501.1517875168.127863.png,/home/dianwen/SIIM_ACR/train/images/1024/mask/1.2.276.0.7230010.3.1.4.8323329.1501.1517875168.127863.png,0.0073490142822265625,1.0,829,880
1.2.276.0.7230010.3.1.4.8323329.1502.1517875168.140307.png,399908,{},1,0,"{""name"":""rect"",""x"":196,""y"":63,""width"":728,""height"":746}",{},746,rect,728,196,63,/home/dianwen/SIIM_ACR/train/images/1024/dicom/1.2.276.0.7230010.3.1.4.8323329.1502.1517875168.140307.png,/home/dianwen/SIIM_ACR/train/images/1024/mask/1.2.276.0.7230010.3.1.4.8323329.1502.1517875168.140307.png,0.0,0.0,809,924
1.2.276.0.7230010.3.1.4.8323329.1503.1517875168.138524.png,361231,{},1,0,"{""name"":""rect"",""x"":99,""y"":147,""width"":816,""height"":692}",{},692,rect,816,99,147,/home/dianwen/SIIM_ACR/train/images/1024/dicom/1.2.276.0.7230010.3.1.4.8323329.1503.1517875168.138524.png,/home/dianwen/SIIM_ACR/train/images/1024/mask/1.2.276.0.7230010.3.1.4.8323329.1503.1517875168.138524.png,0.0,0.0,839,915
1.2.276.0.7230010.3.1.4.8323329.1504.1517875168.149921.png,418114,{},1,0,"{""name"":""rect"",""x"":83,""y"":101,""width"":853,""height"":733}",{},733,rect,853,83,101,/home/dianwen/SIIM_ACR/train/images/1024/dicom/1.2.276.0.7230010.3.1.4.8323329.1504.1517875168.149921.png,/home/dianwen/SIIM_ACR/train/images/1024/mask/1.2.276.0.7230010.3.1.4.8323329.1504.1517875168.149921.png,0.0,0.0,834,936
1.2.276.0.7230010.3.1.4.8323329.1505.1517875168.149805.png,312596,{},1,0,"{""name"":""rect"",""x"":60,""y"":34,""width"":727,""height"":879}",{},879,rect,727,60,34,/home/dianwen/SIIM_ACR/train/images/1024/dicom/1.2.276.0.7230010.3.1.4.8323329.1505.1517875168.149805.png,/home/dianwen/SIIM_ACR/train/images/1024/mask/1.2.276.0.7230010.3.1.4.8323329.1505.1517875168.149805.png,0.011198997497558594,1.0,913,787
1.2.276.0.7230010.3.1.4.8323329.1506.1517875168.149550.png,376697,{},1,0,"{""name"":""rect"",""x"":48,""y"":114,""width"":935,""height"":722}",{},722,rect,935,48,114,/home/dianwen/SIIM_ACR/train/images/1024/dicom/1.2.276.0.7230010.3.1.4.8323329.1506.1517875168.149550.png,/home/dianwen/SIIM_ACR/train/images/1024/mask/1.2.276.0.7230010.3.1.4.8323329.1506.1517875168.149550.png,0.0,0.0,836,983
1.2.276.0.7230010.3.1.4.8323329.1507.1517875168.155698.png,371077,{},1,0,"{""name"":""rect"",""x"":141,""y"":60,""width"":840,""height"":741}",{},741,rect,840,141,60,/home/dianwen/SIIM_ACR/train/images/1024/dicom/1.2.276.0.7230010.3.1.4.8323329.1507.1517875168.155698.png,/home/dianwen/SIIM_ACR/train/images/1024/mask/1.2.276.0.7230010.3.1.4.8323329.1507.1517875168.155698.png,0.006840705871582031,1.0,801,981
1.2.276.0.7230010.3.1.4.8323329.1508.1517875168.167457.png,294436,{},1,0,"{""name"":""rect"",""x"":162,""y"":190,""width"":655,""height"":631}",{},631,rect,655,162,190,/home/dianwen/SIIM_ACR/train/images/1024/dicom/1.2.276.0.7230010.3.1.4.8323329.1508.1517875168.167457.png,/home/dianwen/SIIM_ACR/train/images/1024/mask/1.2.276.0.7230010.3.1.4.8323329.1508.1517875168.167457.png,0.0,0.0,821,817
1.2.276.0.7230010.3.1.4.8323329.1509.1517875168.170477.png,428243,{},1,0,"{""name"":""rect"",""x"":81,""y"":78,""width"":818,""height"":717}",{},717,rect,818,81,78,/home/dianwen/SIIM_ACR/train/images/1024/dicom/1.2.276.0.7230010.3.1.4.8323329.1509.1517875168.170477.png,/home/dianwen/SIIM_ACR/train/images/1024/mask/1.2.276.0.7230010.3.1.4.8323329.1509.1517875168.170477.png,0.0,0.0,795,899
1.2.276.0.7230010.3.1.4.8323329.1510.1517875168.169329.png,427244,{},1,0,"{""name"":""rect"",""x"":87,""y"":109,""width"":799,""height"":703}",{},703,rect,799,87,109,/home/dianwen/SIIM_ACR/train/images/1024/dicom/1.2.276.0.7230010.3.1.4.8323329.1510.1517875168.169329.png,/home/dianwen/SIIM_ACR/train/images/1024/mask/1.2.276.0.7230010.3.1.4.8323329.1510.1517875168.169329.png,0.0,0.0,812,886
1.2.276.0.7230010.3.1.4.8323329.1511.1517875168.177851.png,402264,{},1,0,"{""name"":""rect"",""x"":75,""y"":46,""width"":770,""height"":805}",{},805,rect,770,75,46,/home/dianwen/SIIM_ACR/train/images/1024/dicom/1.2.276.0.7230010.3.1.4.8323329.1511.1517875168.177851.png,/home/dianwen/SIIM_ACR/train/images/1024/mask/1.2.276.0.7230010.3.1.4.8323329.1511.1517875168.177851.png,0.0,0.0,851,845
1.2.276.0.7230010.3.1.4.8323329.1512.1517875168.175004.png,423410,{},1,0,"{""name"":""rect"",""x"":118,""y"":79,""width"":743,""height"":750}",{},750,rect,743,118,79,/home/dianwen/SIIM_ACR/train/images/1024/dicom/1.2.276.0.7230010.3.1.4.8323329.1512.1517875168.175004.png,/home/dianwen/SIIM_ACR/train/images/1024/mask/1.2.276.0.7230010.3.1.4.8323329.1512.1517875168.175004.png,0.006171226501464844,1.0,829,861
1.2.276.0.7230010.3.1.4.8323329.1513.1517875168.185351.png,422899,{},1,0,"{""name"":""rect"",""x"":231,""y"":86,""width"":710,""height"":925}",{},925,rect,710,231,86,/home/dianwen/SIIM_ACR/train/images/1024/dicom/1.2.276.0.7230010.3.1.4.8323329.1513.1517875168.185351.png,/home/dianwen/SIIM_ACR/train/images/1024/mask/1.2.276.0.7230010.3.1.4.8323329.1513.1517875168.185351.png,0.0,0.0,1011,941
1.2.276.0.7230010.3.1.4.8323329.1514.1517875168.183235.png,342022,{},1,0,"{""name"":""rect"",""x"":148,""y"":89,""width"":736,""height"":846}",{},846,rect,736,148,89,/home/dianwen/SIIM_ACR/train/images/1024/dicom/1.2.276.0.7230010.3.1.4.8323329.1514.1517875168.183235.png,/home/dianwen/SIIM_ACR/train/images/1024/mask/1.2.276.0.7230010.3.1.4.8323329.1514.1517875168.183235.png,0.0,0.0,935,884
1.2.276.0.7230010.3.1.4.8323329.1515.1517875168.187200.png,390217,{},1,0,"{""name"":""rect"",""x"":141,""y"":92,""width"":715,""height"":857}",{},857,rect,715,141,92,/home/dianwen/SIIM_ACR/train/images/1024/dicom/1.2.276.0.7230010.3.1.4.8323329.1515.1517875168.187200.png,/home/dianwen/SIIM_ACR/train/images/1024/mask/1.2.276.0.7230010.3.1.4.8323329.1515.1517875168.187200.png,0.008230209350585938,1.0,949,856
1.2.276.0.7230010.3.1.4.8323329.1516.1517875168.192152.png,307287,{},1,0,"{""name"":""rect"",""x"":172,""y"":192,""width"":761,""height"":816}",{},816,rect,761,172,192,/home/dianwen/SIIM_ACR/train/images/1024/dicom/1.2.276.0.7230010.3.1.4.8323329.1516.1517875168.192152.png,/home/dianwen/SIIM_ACR/train/images/1024/mask/1.2.276.0.7230010.3.1.4.8323329.1516.1517875168.192152.png,0.007849693298339844,1.0,1008,933
1.2.276.0.7230010.3.1.4.8323329.1517.1517875168.192790.png,340652,{},1,0,"{""name"":""rect"",""x"":242,""y"":148,""width"":651,""height"":565}",{},565,rect,651,242,148,/home/dianwen/SIIM_ACR/train/images/1024/dicom/1.2.276.0.7230010.3.1.4.8323329.1517.1517875168.192790.png,/home/dianwen/SIIM_ACR/train/images/1024/mask/1.2.276.0.7230010.3.1.4.8323329.1517.1517875168.192790.png,0.0,0.0,713,893
1.2.276.0.7230010.3.1.4.8323329.1518.1517875168.200231.png,407370,{},1,0,"{""name"":""rect"",""x"":137,""y"":62,""width"":774,""height"":868}",{},868,rect,774,137,62,/home/dianwen/SIIM_ACR/train/images/1024/dicom/1.2.276.0.7230010.3.1.4.8323329.1518.1517875168.200231.png,/home/dianwen/SIIM_ACR/train/images/1024/mask/1.2.276.0.7230010.3.1.4.8323329.1518.1517875168.200231.png,0.0,0.0,930,911
1.2.276.0.7230010.3.1.4.8323329.1519.1517875168.209000.png,331328,{},1,0,"{""name"":""rect"",""x"":0,""y"":91,""width"":881,""height"":775}",{},775,rect,881,0,91,/home/dianwen/SIIM_ACR/train/images/1024/dicom/1.2.276.0.7230010.3.1.4.8323329.1519.1517875168.209000.png,/home/dianwen/SIIM_ACR/train/images/1024/mask/1.2.276.0.7230010.3.1.4.8323329.1519.1517875168.209000.png,0.0,0.0,866,881
1.2.276.0.7230010.3.1.4.8323329.1520.1517875168.210173.png,376741,{},1,0,"{""name"":""rect"",""x"":180,""y"":63,""width"":844,""height"":822}",{},822,rect,844,180,63,/home/dianwen/SIIM_ACR/train/images/1024/dicom/1.2.276.0.7230010.3.1.4.8323329.1520.1517875168.210173.png,/home/dianwen/SIIM_ACR/train/images/1024/mask/1.2.276.0.7230010.3.1.4.8323329.1520.1517875168.210173.png,0.0,0.0,885,1024
1.2.276.0.7230010.3.1.4.8323329.1521.1517875168.213792.png,349429,{},1,0,"{""name"":""rect"",""x"":161,""y"":79,""width"":641,""height"":913}",{},913,rect,641,161,79,/home/dianwen/SIIM_ACR/train/images/1024/dicom/1.2.276.0.7230010.3.1.4.8323329.1521.1517875168.213792.png,/home/dianwen/SIIM_ACR/train/images/1024/mask/1.2.276.0.7230010.3.1.4.8323329.1521.1517875168.213792.png,0.0010728836059570312,1.0,992,802
1.2.276.0.7230010.3.1.4.8323329.1522.1517875168.226236.png,389442,{},1,0,"{""name"":""rect"",""x"":86,""y"":96,""width"":861,""height"":792}",{},792,rect,861,86,96,/home/dianwen/SIIM_ACR/train/images/1024/dicom/1.2.276.0.7230010.3.1.4.8323329.1522.1517875168.226236.png,/home/dianwen/SIIM_ACR/train/images/1024/mask/1.2.276.0.7230010.3.1.4.8323329.1522.1517875168.226236.png,0.005323410034179688,1.0,888,947
1.2.276.0.7230010.3.1.4.8323329.1523.1517875168.226413.png,309664,{},1,0,"{""name"":""rect"",""x"":141,""y"":135,""width"":690,""height"":709}",{},709,rect,690,141,135,/home/dianwen/SIIM_ACR/train/images/1024/dicom/1.2.276.0.7230010.3.1.4.8323329.1523.1517875168.226413.png,/home/dianwen/SIIM_ACR/train/images/1024/mask/1.2.276.0.7230010.3.1.4.8323329.1523.1517875168.226413.png,0.0,0.0,844,831
1.2.276.0.7230010.3.1.4.8323329.1524.1517875168.220214.png,414507,{},1,0,"{""name"":""rect"",""x"":122,""y"":35,""width"":751,""height"":706}",{},706,rect,751,122,35,/home/dianwen/SIIM_ACR/train/images/1024/dicom/1.2.276.0.7230010.3.1.4.8323329.1524.1517875168.220214.png,/home/dianwen/SIIM_ACR/train/images/1024/mask/1.2.276.0.7230010.3.1.4.8323329.1524.1517875168.220214.png,0.0,0.0,741,873
1.2.276.0.7230010.3.1.4.8323329.1525.1517875168.230589.png,401665,{},1,0,"{""name"":""rect"",""x"":172,""y"":72,""width"":775,""height"":701}",{},701,rect,775,172,72,/home/dianwen/SIIM_ACR/train/images/1024/dicom/1.2.276.0.7230010.3.1.4.8323329.1525.1517875168.230589.png,/home/dianwen/SIIM_ACR/train/images/1024/mask/1.2.276.0.7230010.3.1.4.8323329.1525.1517875168.230589.png,0.0,0.0,773,947
1.2.276.0.7230010.3.1.4.8323329.1526.1517875168.236594.png,398989,{},1,0,"{""name"":""rect"",""x"":138,""y"":51,""width"":729,""height"":740}",{},740,rect,729,138,51,/home/dianwen/SIIM_ACR/train/images/1024/dicom/1.2.276.0.7230010.3.1.4.8323329.1526.1517875168.236594.png,/home/dianwen/SIIM_ACR/train/images/1024/mask/1.2.276.0.7230010.3.1.4.8323329.1526.1517875168.236594.png,0.0,0.0,791,867
1.2.276.0.7230010.3.1.4.8323329.1527.1517875168.236420.png,377740,{},1,0,"{""name"":""rect"",""x"":115,""y"":72,""width"":742,""height"":762}",{},762,rect,742,115,72,/home/dianwen/SIIM_ACR/train/images/1024/dicom/1.2.276.0.7230010.3.1.4.8323329.1527.1517875168.236420.png,/home/dianwen/SIIM_ACR/train/images/1024/mask/1.2.276.0.7230010.3.1.4.8323329.1527.1517875168.236420.png,0.00150299072265625,1.0,834,857
1.2.276.0.7230010.3.1.4.8323329.1528.1517875168.235731.png,355778,{},1,0,"{""name"":""rect"",""x"":9,""y"":164,""width"":1001,""height"":791}",{},791,rect,1001,9,164,/home/dianwen/SIIM_ACR/train/images/1024/dicom/1.2.276.0.7230010.3.1.4.8323329.1528.1517875168.235731.png,/home/dianwen/SIIM_ACR/train/images/1024/mask/1.2.276.0.7230010.3.1.4.8323329.1528.1517875168.235731.png,0.0,0.0,955,1010
1.2.276.0.7230010.3.1.4.8323329.1529.1517875168.239585.png,445746,{},1,0,"{""name"":""rect"",""x"":200,""y"":69,""width"":652,""height"":824}",{},824,rect,652,200,69,/home/dianwen/SIIM_ACR/train/images/1024/dicom/1.2.276.0.7230010.3.1.4.8323329.1529.1517875168.239585.png,/home/dianwen/SIIM_ACR/train/images/1024/mask/1.2.276.0.7230010.3.1.4.8323329.1529.1517875168.239585.png,0.0,0.0,893,852
1.2.276.0.7230010.3.1.4.8323329.1530.1517875168.249792.png,368328,{},1,0,"{""name"":""rect"",""x"":135,""y"":133,""width"":684,""height"":761}",{},761,rect,684,135,133,/home/dianwen/SIIM_ACR/train/images/1024/dicom/1.2.276.0.7230010.3.1.4.8323329.1530.1517875168.249792.png,/home/dianwen/SIIM_ACR/train/images/1024/mask/1.2.276.0.7230010.3.1.4.8323329.1530.1517875168.249792.png,0.017019271850585938,1.0,894,819
1.2.276.0.7230010.3.1.4.8323329.1531.1517875168.248619.png,389302,{},1,0,"{""name"":""rect"",""x"":84,""y"":87,""width"":923,""height"":855}",{},855,rect,923,84,87,/home/dianwen/SIIM_ACR/train/images/1024/dicom/1.2.276.0.7230010.3.1.4.8323329.1531.1517875168.248619.png,/home/dianwen/SIIM_ACR/train/images/1024/mask/1.2.276.0.7230010.3.1.4.8323329.1531.1517875168.248619.png,0.0,0.0,942,1007
1.2.276.0.7230010.3.1.4.8323329.1532.1517875168.249415.png,411893,{},1,0,"{""name"":""rect"",""x"":69,""y"":100,""width"":804,""height"":712}",{},712,rect,804,69,100,/home/dianwen/SIIM_ACR/train/images/1024/dicom/1.2.276.0.7230010.3.1.4.8323329.1532.1517875168.249415.png,/home/dianwen/SIIM_ACR/train/images/1024/mask/1.2.276.0.7230010.3.1.4.8323329.1532.1517875168.249415.png,0.0020008087158203125,1.0,812,873
1.2.276.0.7230010.3.1.4.8323329.1533.1517875168.262192.png,328054,{},1,0,"{""name"":""rect"",""x"":93,""y"":70,""width"":808,""height"":818}",{},818,rect,808,93,70,/home/dianwen/SIIM_ACR/train/images/1024/dicom/1.2.276.0.7230010.3.1.4.8323329.1533.1517875168.262192.png,/home/dianwen/SIIM_ACR/train/images/1024/mask/1.2.276.0.7230010.3.1.4.8323329.1533.1517875168.262192.png,0.013341903686523438,1.0,888,901
1.2.276.0.7230010.3.1.4.8323329.1534.1517875168.260878.png,420935,{},1,0,"{""name"":""rect"",""x"":99,""y"":157,""width"":835,""height"":662}",{},662,rect,835,99,157,/home/dianwen/SIIM_ACR/train/images/1024/dicom/1.2.276.0.7230010.3.1.4.8323329.1534.1517875168.260878.png,/home/dianwen/SIIM_ACR/train/images/1024/mask/1.2.276.0.7230010.3.1.4.8323329.1534.1517875168.260878.png,0.0,0.0,819,934
1.2.276.0.7230010.3.1.4.8323329.1535.1517875168.274056.png,390969,{},1,0,"{""name"":""rect"",""x"":220,""y"":98,""width"":682,""height"":813}",{},813,rect,682,220,98,/home/dianwen/SIIM_ACR/train/images/1024/dicom/1.2.276.0.7230010.3.1.4.8323329.1535.1517875168.274056.png,/home/dianwen/SIIM_ACR/train/images/1024/mask/1.2.276.0.7230010.3.1.4.8323329.1535.1517875168.274056.png,0.0,0.0,911,902
1.2.276.0.7230010.3.1.4.8323329.1536.1517875168.273817.png,431663,{},1,0,"{""name"":""rect"",""x"":143,""y"":50,""width"":797,""height"":715}",{},715,rect,797,143,50,/home/dianwen/SIIM_ACR/train/images/1024/dicom/1.2.276.0.7230010.3.1.4.8323329.1536.1517875168.273817.png,/home/dianwen/SIIM_ACR/train/images/1024/mask/1.2.276.0.7230010.3.1.4.8323329.1536.1517875168.273817.png,0.0,0.0,765,940
1.2.276.0.7230010.3.1.4.8323329.1537.1517875168.281914.png,418654,{},1,0,"{""name"":""rect"",""x"":121,""y"":120,""width"":760,""height"":656}",{},656,rect,760,121,120,/home/dianwen/SIIM_ACR/train/images/1024/dicom/1.2.276.0.7230010.3.1.4.8323329.1537.1517875168.281914.png,/home/dianwen/SIIM_ACR/train/images/1024/mask/1.2.276.0.7230010.3.1.4.8323329.1537.1517875168.281914.png,0.0,0.0,776,881
1.2.276.0.7230010.3.1.4.8323329.1538.1517875168.287693.png,376905,{},1,0,"{""name"":""rect"",""x"":207,""y"":142,""width"":675,""height"":690}",{},690,rect,675,207,142,/home/dianwen/SIIM_ACR/train/images/1024/dicom/1.2.276.0.7230010.3.1.4.8323329.1538.1517875168.287693.png,/home/dianwen/SIIM_ACR/train/images/1024/mask/1.2.276.0.7230010.3.1.4.8323329.1538.1517875168.287693.png,0.0,0.0,832,882
1.2.276.0.7230010.3.1.4.8323329.1539.1517875168.288447.png,368276,{},1,0,"{""name"":""rect"",""x"":139,""y"":91,""width"":778,""height"":758}",{},758,rect,778,139,91,/home/dianwen/SIIM_ACR/train/images/1024/dicom/1.2.276.0.7230010.3.1.4.8323329.1539.1517875168.288447.png,/home/dianwen/SIIM_ACR/train/images/1024/mask/1.2.276.0.7230010.3.1.4.8323329.1539.1517875168.288447.png,0.0,0.0,849,917
1.2.276.0.7230010.3.1.4.8323329.1540.1517875168.296187.png,459021,{},1,0,"{""name"":""rect"",""x"":174,""y"":123,""width"":652,""height"":555}",{},555,rect,652,174,123,/home/dianwen/SIIM_ACR/train/images/1024/dicom/1.2.276.0.7230010.3.1.4.8323329.1540.1517875168.296187.png,/home/dianwen/SIIM_ACR/train/images/1024/mask/1.2.276.0.7230010.3.1.4.8323329.1540.1517875168.296187.png,0.0,0.0,678,826
1.2.276.0.7230010.3.1.4.8323329.1541.1517875168.295822.png,336135,{},1,0,"{""name"":""rect"",""x"":173,""y"":32,""width"":685,""height"":863}",{},863,rect,685,173,32,/home/dianwen/SIIM_ACR/train/images/1024/dicom/1.2.276.0.7230010.3.1.4.8323329.1541.1517875168.295822.png,/home/dianwen/SIIM_ACR/train/images/1024/mask/1.2.276.0.7230010.3.1.4.8323329.1541.1517875168.295822.png,0.008174896240234375,1.0,895,858
1.2.276.0.7230010.3.1.4.8323329.1542.1517875168.300833.png,385014,{},1,0,"{""name"":""rect"",""x"":101,""y"":195,""width"":882,""height"":668}",{},668,rect,882,101,195,/home/dianwen/SIIM_ACR/train/images/1024/dicom/1.2.276.0.7230010.3.1.4.8323329.1542.1517875168.300833.png,/home/dianwen/SIIM_ACR/train/images/1024/mask/1.2.276.0.7230010.3.1.4.8323329.1542.1517875168.300833.png,0.0,0.0,863,983
1.2.276.0.7230010.3.1.4.8323329.1543.1517875168.312014.png,431079,{},1,0,"{""name"":""rect"",""x"":90,""y"":79,""width"":788,""height"":737}",{},737,rect,788,90,79,/home/dianwen/SIIM_ACR/train/images/1024/dicom/1.2.276.0.7230010.3.1.4.8323329.1543.1517875168.312014.png,/home/dianwen/SIIM_ACR/train/images/1024/mask/1.2.276.0.7230010.3.1.4.8323329.1543.1517875168.312014.png,0.0,0.0,816,878
1.2.276.0.7230010.3.1.4.8323329.1544.1517875168.315001.png,422031,{},1,0,"{""name"":""rect"",""x"":144,""y"":110,""width"":759,""height"":780}",{},780,rect,759,144,110,/home/dianwen/SIIM_ACR/train/images/1024/dicom/1.2.276.0.7230010.3.1.4.8323329.1544.1517875168.315001.png,/home/dianwen/SIIM_ACR/train/images/1024/mask/1.2.276.0.7230010.3.1.4.8323329.1544.1517875168.315001.png,0.0,0.0,890,903
1.2.276.0.7230010.3.1.4.8323329.1545.1517875168.317177.png,366391,{},1,0,"{""name"":""rect"",""x"":165,""y"":74,""width"":768,""height"":693}",{},693,rect,768,165,74,/home/dianwen/SIIM_ACR/train/images/1024/dicom/1.2.276.0.7230010.3.1.4.8323329.1545.1517875168.317177.png,/home/dianwen/SIIM_ACR/train/images/1024/mask/1.2.276.0.7230010.3.1.4.8323329.1545.1517875168.317177.png,0.0,0.0,767,933
1.2.276.0.7230010.3.1.4.8323329.1546.1517875168.319844.png,310683,{},1,0,"{""name"":""rect"",""x"":279,""y"":149,""width"":664,""height"":709}",{},709,rect,664,279,149,/home/dianwen/SIIM_ACR/train/images/1024/dicom/1.2.276.0.7230010.3.1.4.8323329.1546.1517875168.319844.png,/home/dianwen/SIIM_ACR/train/images/1024/mask/1.2.276.0.7230010.3.1.4.8323329.1546.1517875168.319844.png,0.0,0.0,858,943
1.2.276.0.7230010.3.1.4.8323329.1547.1517875168.342561.png,384892,{},1,0,"{""name"":""rect"",""x"":197,""y"":110,""width"":649,""height"":766}",{},766,rect,649,197,110,/home/dianwen/SIIM_ACR/train/images/1024/dicom/1.2.276.0.7230010.3.1.4.8323329.1547.1517875168.342561.png,/home/dianwen/SIIM_ACR/train/images/1024/mask/1.2.276.0.7230010.3.1.4.8323329.1547.1517875168.342561.png,0.0,0.0,876,846
1.2.276.0.7230010.3.1.4.8323329.1548.1517875168.338547.png,416830,{},1,0,"{""name"":""rect"",""x"":62,""y"":26,""width"":857,""height"":997}",{},997,rect,857,62,26,/home/dianwen/SIIM_ACR/train/images/1024/dicom/1.2.276.0.7230010.3.1.4.8323329.1548.1517875168.338547.png,/home/dianwen/SIIM_ACR/train/images/1024/mask/1.2.276.0.7230010.3.1.4.8323329.1548.1517875168.338547.png,0.0,0.0,1023,919
1.2.276.0.7230010.3.1.4.8323329.1549.1517875168.367445.png,340786,{},1,0,"{""name"":""rect"",""x"":84,""y"":65,""width"":874,""height"":845}",{},845,rect,874,84,65,/home/dianwen/SIIM_ACR/train/images/1024/dicom/1.2.276.0.7230010.3.1.4.8323329.1549.1517875168.367445.png,/home/dianwen/SIIM_ACR/train/images/1024/mask/1.2.276.0.7230010.3.1.4.8323329.1549.1517875168.367445.png,0.0,0.0,910,958
1.2.276.0.7230010.3.1.4.8323329.1550.1517875168.365705.png,358796,{},1,0,"{""name"":""rect"",""x"":87,""y"":122,""width"":850,""height"":889}",{},889,rect,850,87,122,/home/dianwen/SIIM_ACR/train/images/1024/dicom/1.2.276.0.7230010.3.1.4.8323329.1550.1517875168.365705.png,/home/dianwen/SIIM_ACR/train/images/1024/mask/1.2.276.0.7230010.3.1.4.8323329.1550.1517875168.365705.png,0.0,0.0,1011,937
1.2.276.0.7230010.3.1.4.8323329.1551.1517875168.374267.png,373460,{},1,0,"{""name"":""rect"",""x"":38,""y"":270,""width"":799,""height"":753}",{},753,rect,799,38,270,/home/dianwen/SIIM_ACR/train/images/1024/dicom/1.2.276.0.7230010.3.1.4.8323329.1551.1517875168.374267.png,/home/dianwen/SIIM_ACR/train/images/1024/mask/1.2.276.0.7230010.3.1.4.8323329.1551.1517875168.374267.png,0.0,0.0,1023,837
1.2.276.0.7230010.3.1.4.8323329.1552.1517875168.374425.png,428151,{},1,0,"{""name"":""rect"",""x"":130,""y"":110,""width"":799,""height"":654}",{},654,rect,799,130,110,/home/dianwen/SIIM_ACR/train/images/1024/dicom/1.2.276.0.7230010.3.1.4.8323329.1552.1517875168.374425.png,/home/dianwen/SIIM_ACR/train/images/1024/mask/1.2.276.0.7230010.3.1.4.8323329.1552.1517875168.374425.png,0.0016613006591796875,1.0,764,929
1.2.276.0.7230010.3.1.4.8323329.1553.1517875168.374910.png,345045,{},1,0,"{""name"":""rect"",""x"":38,""y"":99,""width"":889,""height"":706}",{},706,rect,889,38,99,/home/dianwen/SIIM_ACR/train/images/1024/dicom/1.2.276.0.7230010.3.1.4.8323329.1553.1517875168.374910.png,/home/dianwen/SIIM_ACR/train/images/1024/mask/1.2.276.0.7230010.3.1.4.8323329.1553.1517875168.374910.png,0.0023746490478515625,1.0,805,927
1.2.276.0.7230010.3.1.4.8323329.1554.1517875168.395268.png,433304,{},1,0,"{""name"":""rect"",""x"":114,""y"":110,""width"":870,""height"":867}",{},867,rect,870,114,110,/home/dianwen/SIIM_ACR/train/images/1024/dicom/1.2.276.0.7230010.3.1.4.8323329.1554.1517875168.395268.png,/home/dianwen/SIIM_ACR/train/images/1024/mask/1.2.276.0.7230010.3.1.4.8323329.1554.1517875168.395268.png,0.0037622451782226562,1.0,977,984
1.2.276.0.7230010.3.1.4.8323329.1555.1517875168.395268.png,404838,{},1,0,"{""name"":""rect"",""x"":120,""y"":43,""width"":833,""height"":628}",{},628,rect,833,120,43,/home/dianwen/SIIM_ACR/train/images/1024/dicom/1.2.276.0.7230010.3.1.4.8323329.1555.1517875168.395268.png,/home/dianwen/SIIM_ACR/train/images/1024/mask/1.2.276.0.7230010.3.1.4.8323329.1555.1517875168.395268.png,0.0,0.0,671,953
1.2.276.0.7230010.3.1.4.8323329.1556.1517875168.390347.png,437368,{},1,0,"{""name"":""rect"",""x"":182,""y"":55,""width"":783,""height"":698}",{},698,rect,783,182,55,/home/dianwen/SIIM_ACR/train/images/1024/dicom/1.2.276.0.7230010.3.1.4.8323329.1556.1517875168.390347.png,/home/dianwen/SIIM_ACR/train/images/1024/mask/1.2.276.0.7230010.3.1.4.8323329.1556.1517875168.390347.png,0.0008296966552734375,1.0,753,965
1.2.276.0.7230010.3.1.4.8323329.1557.1517875168.394768.png,425913,{},1,0,"{""name"":""rect"",""x"":54,""y"":131,""width"":843,""height"":831}",{},831,rect,843,54,131,/home/dianwen/SIIM_ACR/train/images/1024/dicom/1.2.276.0.7230010.3.1.4.8323329.1557.1517875168.394768.png,/home/dianwen/SIIM_ACR/train/images/1024/mask/1.2.276.0.7230010.3.1.4.8323329.1557.1517875168.394768.png,0.009776115417480469,1.0,962,897
1.2.276.0.7230010.3.1.4.8323329.1558.1517875168.394158.png,440487,{},1,0,"{""name"":""rect"",""x"":3,""y"":40,""width"":894,""height"":980}",{},980,rect,894,3,40,/home/dianwen/SIIM_ACR/train/images/1024/dicom/1.2.276.0.7230010.3.1.4.8323329.1558.1517875168.394158.png,/home/dianwen/SIIM_ACR/train/images/1024/mask/1.2.276.0.7230010.3.1.4.8323329.1558.1517875168.394158.png,0.030104637145996094,1.0,1020,897
1.2.276.0.7230010.3.1.4.8323329.1559.1517875168.403745.png,352460,{},1,0,"{""name"":""rect"",""x"":122,""y"":128,""width"":794,""height"":717}",{},717,rect,794,122,128,/home/dianwen/SIIM_ACR/train/images/1024/dicom/1.2.276.0.7230010.3.1.4.8323329.1559.1517875168.403745.png,/home/dianwen/SIIM_ACR/train/images/1024/mask/1.2.276.0.7230010.3.1.4.8323329.1559.1517875168.403745.png,0.0,0.0,845,916
1.2.276.0.7230010.3.1.4.8323329.1560.1517875168.414537.png,367193,{},1,0,"{""name"":""rect"",""x"":111,""y"":3,""width"":862,""height"":829}",{},829,rect,862,111,3,/home/dianwen/SIIM_ACR/train/images/1024/dicom/1.2.276.0.7230010.3.1.4.8323329.1560.1517875168.414537.png,/home/dianwen/SIIM_ACR/train/images/1024/mask/1.2.276.0.7230010.3.1.4.8323329.1560.1517875168.414537.png,0.0,0.0,832,973
1.2.276.0.7230010.3.1.4.8323329.1561.1517875168.421792.png,368172,{},1,0,"{""name"":""rect"",""x"":92,""y"":120,""width"":643,""height"":904}",{},904,rect,643,92,120,/home/dianwen/SIIM_ACR/train/images/1024/dicom/1.2.276.0.7230010.3.1.4.8323329.1561.1517875168.421792.png,/home/dianwen/SIIM_ACR/train/images/1024/mask/1.2.276.0.7230010.3.1.4.8323329.1561.1517875168.421792.png,0.0,0.0,1024,735
1.2.276.0.7230010.3.1.4.8323329.1562.1517875168.418765.png,416540,{},1,0,"{""name"":""rect"",""x"":155,""y"":112,""width"":731,""height"":833}",{},833,rect,731,155,112,/home/dianwen/SIIM_ACR/train/images/1024/dicom/1.2.276.0.7230010.3.1.4.8323329.1562.1517875168.418765.png,/home/dianwen/SIIM_ACR/train/images/1024/mask/1.2.276.0.7230010.3.1.4.8323329.1562.1517875168.418765.png,0.0,0.0,945,886
1.2.276.0.7230010.3.1.4.8323329.1563.1517875168.424425.png,365761,{},1,0,"{""name"":""rect"",""x"":200,""y"":171,""width"":702,""height"":765}",{},765,rect,702,200,171,/home/dianwen/SIIM_ACR/train/images/1024/dicom/1.2.276.0.7230010.3.1.4.8323329.1563.1517875168.424425.png,/home/dianwen/SIIM_ACR/train/images/1024/mask/1.2.276.0.7230010.3.1.4.8323329.1563.1517875168.424425.png,0.0,0.0,936,902
1.2.276.0.7230010.3.1.4.8323329.1564.1517875168.432108.png,369689,{},1,0,"{""name"":""rect"",""x"":140,""y"":118,""width"":884,""height"":886}",{},886,rect,884,140,118,/home/dianwen/SIIM_ACR/train/images/1024/dicom/1.2.276.0.7230010.3.1.4.8323329.1564.1517875168.432108.png,/home/dianwen/SIIM_ACR/train/images/1024/mask/1.2.276.0.7230010.3.1.4.8323329.1564.1517875168.432108.png,0.0,0.0,1004,1024
1.2.276.0.7230010.3.1.4.8323329.1565.1517875168.431703.png,420699,{},1,0,"{""name"":""rect"",""x"":106,""y"":51,""width"":768,""height"":973}",{},973,rect,768,106,51,/home/dianwen/SIIM_ACR/train/images/1024/dicom/1.2.276.0.7230010.3.1.4.8323329.1565.1517875168.431703.png,/home/dianwen/SIIM_ACR/train/images/1024/mask/1.2.276.0.7230010.3.1.4.8323329.1565.1517875168.431703.png,0.0,0.0,1024,874
1.2.276.0.7230010.3.1.4.8323329.1566.1517875168.443645.png,312730,{},1,0,"{""name"":""rect"",""x"":193,""y"":234,""width"":657,""height"":750}",{},750,rect,657,193,234,/home/dianwen/SIIM_ACR/train/images/1024/dicom/1.2.276.0.7230010.3.1.4.8323329.1566.1517875168.443645.png,/home/dianwen/SIIM_ACR/train/images/1024/mask/1.2.276.0.7230010.3.1.4.8323329.1566.1517875168.443645.png,0.0,0.0,984,850
1.2.276.0.7230010.3.1.4.8323329.1567.1517875168.435203.png,431573,{},1,0,"{""name"":""rect"",""x"":36,""y"":91,""width"":867,""height"":851}",{},851,rect,867,36,91,/home/dianwen/SIIM_ACR/train/images/1024/dicom/1.2.276.0.7230010.3.1.4.8323329.1567.1517875168.435203.png,/home/dianwen/SIIM_ACR/train/images/1024/mask/1.2.276.0.7230010.3.1.4.8323329.1567.1517875168.435203.png,0.0,0.0,942,903
1.2.276.0.7230010.3.1.4.8323329.1568.1517875168.448529.png,343047,{},1,0,"{""name"":""rect"",""x"":160,""y"":121,""width"":684,""height"":797}",{},797,rect,684,160,121,/home/dianwen/SIIM_ACR/train/images/1024/dicom/1.2.276.0.7230010.3.1.4.8323329.1568.1517875168.448529.png,/home/dianwen/SIIM_ACR/train/images/1024/mask/1.2.276.0.7230010.3.1.4.8323329.1568.1517875168.448529.png,0.0,0.0,918,844
1.2.276.0.7230010.3.1.4.8323329.1569.1517875168.444765.png,428789,{},1,0,"{""name"":""rect"",""x"":39,""y"":53,""width"":813,""height"":809}",{},809,rect,813,39,53,/home/dianwen/SIIM_ACR/train/images/1024/dicom/1.2.276.0.7230010.3.1.4.8323329.1569.1517875168.444765.png,/home/dianwen/SIIM_ACR/train/images/1024/mask/1.2.276.0.7230010.3.1.4.8323329.1569.1517875168.444765.png,0.043213844299316406,1.0,862,852
1.2.276.0.7230010.3.1.4.8323329.1570.1517875168.449138.png,449244,{},1,0,"{""name"":""rect"",""x"":140,""y"":91,""width"":811,""height"":703}",{},703,rect,811,140,91,/home/dianwen/SIIM_ACR/train/images/1024/dicom/1.2.276.0.7230010.3.1.4.8323329.1570.1517875168.449138.png,/home/dianwen/SIIM_ACR/train/images/1024/mask/1.2.276.0.7230010.3.1.4.8323329.1570.1517875168.449138.png,0.0,0.0,794,951
1.2.276.0.7230010.3.1.4.8323329.1571.1517875168.459745.png,431022,{},1,0,"{""name"":""rect"",""x"":99,""y"":33,""width"":893,""height"":966}",{},966,rect,893,99,33,/home/dianwen/SIIM_ACR/train/images/1024/dicom/1.2.276.0.7230010.3.1.4.8323329.1571.1517875168.459745.png,/home/dianwen/SIIM_ACR/train/images/1024/mask/1.2.276.0.7230010.3.1.4.8323329.1571.1517875168.459745.png,0.0,0.0,999,992
1.2.276.0.7230010.3.1.4.8323329.1572.1517875168.460640.png,425297,{},1,0,"{""name"":""rect"",""x"":110,""y"":67,""width"":791,""height"":692}",{},692,rect,791,110,67,/home/dianwen/SIIM_ACR/train/images/1024/dicom/1.2.276.0.7230010.3.1.4.8323329.1572.1517875168.460640.png,/home/dianwen/SIIM_ACR/train/images/1024/mask/1.2.276.0.7230010.3.1.4.8323329.1572.1517875168.460640.png,0.0,0.0,759,901
1.2.276.0.7230010.3.1.4.8323329.1573.1517875168.461904.png,458449,{},1,0,"{""name"":""rect"",""x"":93,""y"":98,""width"":828,""height"":794}",{},794,rect,828,93,98,/home/dianwen/SIIM_ACR/train/images/1024/dicom/1.2.276.0.7230010.3.1.4.8323329.1573.1517875168.461904.png,/home/dianwen/SIIM_ACR/train/images/1024/mask/1.2.276.0.7230010.3.1.4.8323329.1573.1517875168.461904.png,0.016394615173339844,1.0,892,921
1.2.276.0.7230010.3.1.4.8323329.1574.1517875168.459129.png,369429,{},1,0,"{""name"":""rect"",""x"":57,""y"":104,""width"":820,""height"":845}",{},845,rect,820,57,104,/home/dianwen/SIIM_ACR/train/images/1024/dicom/1.2.276.0.7230010.3.1.4.8323329.1574.1517875168.459129.png,/home/dianwen/SIIM_ACR/train/images/1024/mask/1.2.276.0.7230010.3.1.4.8323329.1574.1517875168.459129.png,0.0023345947265625,1.0,949,877
1.2.276.0.7230010.3.1.4.8323329.1575.1517875168.464524.png,329647,{},1,0,"{""name"":""rect"",""x"":95,""y"":127,""width"":609,""height"":878}",{},878,rect,609,95,127,/home/dianwen/SIIM_ACR/train/images/1024/dicom/1.2.276.0.7230010.3.1.4.8323329.1575.1517875168.464524.png,/home/dianwen/SIIM_ACR/train/images/1024/mask/1.2.276.0.7230010.3.1.4.8323329.1575.1517875168.464524.png,0.018807411193847656,1.0,1005,704
1.2.276.0.7230010.3.1.4.8323329.1576.1517875168.475041.png,381505,{},1,0,"{""name"":""rect"",""x"":163,""y"":59,""width"":739,""height"":750}",{},750,rect,739,163,59,/home/dianwen/SIIM_ACR/train/images/1024/dicom/1.2.276.0.7230010.3.1.4.8323329.1576.1517875168.475041.png,/home/dianwen/SIIM_ACR/train/images/1024/mask/1.2.276.0.7230010.3.1.4.8323329.1576.1517875168.475041.png,0.0,0.0,809,902
1.2.276.0.7230010.3.1.4.8323329.1577.1517875168.477894.png,381107,{},1,0,"{""name"":""rect"",""x"":219,""y"":143,""width"":768,""height"":667}",{},667,rect,768,219,143,/home/dianwen/SIIM_ACR/train/images/1024/dicom/1.2.276.0.7230010.3.1.4.8323329.1577.1517875168.477894.png,/home/dianwen/SIIM_ACR/train/images/1024/mask/1.2.276.0.7230010.3.1.4.8323329.1577.1517875168.477894.png,0.001712799072265625,1.0,810,987
1.2.276.0.7230010.3.1.4.8323329.1578.1517875168.477050.png,411552,{},1,0,"{""name"":""rect"",""x"":166,""y"":86,""width"":719,""height"":756}",{},756,rect,719,166,86,/home/dianwen/SIIM_ACR/train/images/1024/dicom/1.2.276.0.7230010.3.1.4.8323329.1578.1517875168.477050.png,/home/dianwen/SIIM_ACR/train/images/1024/mask/1.2.276.0.7230010.3.1.4.8323329.1578.1517875168.477050.png,0.0,0.0,842,885
1.2.276.0.7230010.3.1.4.8323329.1579.1517875168.488094.png,321910,{},1,0,"{""name"":""rect"",""x"":185,""y"":81,""width"":718,""height"":768}",{},768,rect,718,185,81,/home/dianwen/SIIM_ACR/train/images/1024/dicom/1.2.276.0.7230010.3.1.4.8323329.1579.1517875168.488094.png,/home/dianwen/SIIM_ACR/train/images/1024/mask/1.2.276.0.7230010.3.1.4.8323329.1579.1517875168.488094.png,0.0,0.0,849,903
1.2.276.0.7230010.3.1.4.8323329.1580.1517875168.493065.png,328670,{},1,0,"{""name"":""rect"",""x"":182,""y"":160,""width"":709,""height"":762}",{},762,rect,709,182,160,/home/dianwen/SIIM_ACR/train/images/1024/dicom/1.2.276.0.7230010.3.1.4.8323329.1580.1517875168.493065.png,/home/dianwen/SIIM_ACR/train/images/1024/mask/1.2.276.0.7230010.3.1.4.8323329.1580.1517875168.493065.png,0.0,0.0,922,891
1.2.276.0.7230010.3.1.4.8323329.1581.1517875168.489637.png,329847,{},1,0,"{""name"":""rect"",""x"":112,""y"":117,""width"":778,""height"":554}",{},554,rect,778,112,117,/home/dianwen/SIIM_ACR/train/images/1024/dicom/1.2.276.0.7230010.3.1.4.8323329.1581.1517875168.489637.png,/home/dianwen/SIIM_ACR/train/images/1024/mask/1.2.276.0.7230010.3.1.4.8323329.1581.1517875168.489637.png,0.0,0.0,671,890
1.2.276.0.7230010.3.1.4.8323329.1582.1517875168.499039.png,443226,{},1,0,"{""name"":""rect"",""x"":126,""y"":45,""width"":801,""height"":966}",{},966,rect,801,126,45,/home/dianwen/SIIM_ACR/train/images/1024/dicom/1.2.276.0.7230010.3.1.4.8323329.1582.1517875168.499039.png,/home/dianwen/SIIM_ACR/train/images/1024/mask/1.2.276.0.7230010.3.1.4.8323329.1582.1517875168.499039.png,0.0,0.0,1011,927
1.2.276.0.7230010.3.1.4.8323329.1583.1517875168.499993.png,412047,{},1,0,"{""name"":""rect"",""x"":96,""y"":42,""width"":827,""height"":895}",{},895,rect,827,96,42,/home/dianwen/SIIM_ACR/train/images/1024/dicom/1.2.276.0.7230010.3.1.4.8323329.1583.1517875168.499993.png,/home/dianwen/SIIM_ACR/train/images/1024/mask/1.2.276.0.7230010.3.1.4.8323329.1583.1517875168.499993.png,0.0,0.0,937,923
1.2.276.0.7230010.3.1.4.8323329.1584.1517875168.503163.png,425358,{},1,0,"{""name"":""rect"",""x"":118,""y"":65,""width"":783,""height"":726}",{},726,rect,783,118,65,/home/dianwen/SIIM_ACR/train/images/1024/dicom/1.2.276.0.7230010.3.1.4.8323329.1584.1517875168.503163.png,/home/dianwen/SIIM_ACR/train/images/1024/mask/1.2.276.0.7230010.3.1.4.8323329.1584.1517875168.503163.png,0.0,0.0,791,901
1.2.276.0.7230010.3.1.4.8323329.1586.1517875168.514100.png,407449,{},1,0,"{""name"":""rect"",""x"":182,""y"":134,""width"":686,""height"":775}",{},775,rect,686,182,134,/home/dianwen/SIIM_ACR/train/images/1024/dicom/1.2.276.0.7230010.3.1.4.8323329.1586.1517875168.514100.png,/home/dianwen/SIIM_ACR/train/images/1024/mask/1.2.276.0.7230010.3.1.4.8323329.1586.1517875168.514100.png,0.0059334030374884605,1.0,909,868
1.2.276.0.7230010.3.1.4.8323329.1587.1517875168.515865.png,404008,{},1,0,"{""name"":""rect"",""x"":112,""y"":120,""width"":748,""height"":766}",{},766,rect,748,112,120,/home/dianwen/SIIM_ACR/train/images/1024/dicom/1.2.276.0.7230010.3.1.4.8323329.1587.1517875168.515865.png,/home/dianwen/SIIM_ACR/train/images/1024/mask/1.2.276.0.7230010.3.1.4.8323329.1587.1517875168.515865.png,0.0,0.0,886,860
1.2.276.0.7230010.3.1.4.8323329.1588.1517875168.503026.png,396431,{},1,0,"{""name"":""rect"",""x"":166,""y"":117,""width"":725,""height"":685}",{},685,rect,725,166,117,/home/dianwen/SIIM_ACR/train/images/1024/dicom/1.2.276.0.7230010.3.1.4.8323329.1588.1517875168.503026.png,/home/dianwen/SIIM_ACR/train/images/1024/mask/1.2.276.0.7230010.3.1.4.8323329.1588.1517875168.503026.png,0.0,0.0,802,891
1.2.276.0.7230010.3.1.4.8323329.1589.1517875168.517488.png,426214,{},1,0,"{""name"":""rect"",""x"":134,""y"":164,""width"":758,""height"":668}",{},668,rect,758,134,164,/home/dianwen/SIIM_ACR/train/images/1024/dicom/1.2.276.0.7230010.3.1.4.8323329.1589.1517875168.517488.png,/home/dianwen/SIIM_ACR/train/images/1024/mask/1.2.276.0.7230010.3.1.4.8323329.1589.1517875168.517488.png,0.005570411682128906,1.0,832,892
1.2.276.0.7230010.3.1.4.8323329.1590.1517875168.517088.png,342698,{},1,0,"{""name"":""rect"",""x"":88,""y"":117,""width"":936,""height"":657}",{},657,rect,936,88,117,/home/dianwen/SIIM_ACR/train/images/1024/dicom/1.2.276.0.7230010.3.1.4.8323329.1590.1517875168.517088.png,/home/dianwen/SIIM_ACR/train/images/1024/mask/1.2.276.0.7230010.3.1.4.8323329.1590.1517875168.517088.png,0.0,0.0,774,1024
1.2.276.0.7230010.3.1.4.8323329.1591.1517875168.523019.png,406034,{},1,0,"{""name"":""rect"",""x"":147,""y"":194,""width"":756,""height"":799}",{},799,rect,756,147,194,/home/dianwen/SIIM_ACR/train/images/1024/dicom/1.2.276.0.7230010.3.1.4.8323329.1591.1517875168.523019.png,/home/dianwen/SIIM_ACR/train/images/1024/mask/1.2.276.0.7230010.3.1.4.8323329.1591.1517875168.523019.png,0.0,0.0,993,903
1.2.276.0.7230010.3.1.4.8323329.1592.1517875168.533276.png,362247,{},1,0,"{""name"":""rect"",""x"":103,""y"":128,""width"":877,""height"":895}",{},895,rect,877,103,128,/home/dianwen/SIIM_ACR/train/images/1024/dicom/1.2.276.0.7230010.3.1.4.8323329.1592.1517875168.533276.png,/home/dianwen/SIIM_ACR/train/images/1024/mask/1.2.276.0.7230010.3.1.4.8323329.1592.1517875168.533276.png,0.0,0.0,1023,980
1.2.276.0.7230010.3.1.4.8323329.1593.1517875168.530966.png,408833,{},1,0,"{""name"":""rect"",""x"":140,""y"":91,""width"":752,""height"":634}",{},634,rect,752,140,91,/home/dianwen/SIIM_ACR/train/images/1024/dicom/1.2.276.0.7230010.3.1.4.8323329.1593.1517875168.530966.png,/home/dianwen/SIIM_ACR/train/images/1024/mask/1.2.276.0.7230010.3.1.4.8323329.1593.1517875168.530966.png,0.0,0.0,725,892
1.2.276.0.7230010.3.1.4.8323329.1594.1517875168.538310.png,366826,{},1,0,"{""name"":""rect"",""x"":67,""y"":14,""width"":935,""height"":802}",{},802,rect,935,67,14,/home/dianwen/SIIM_ACR/train/images/1024/dicom/1.2.276.0.7230010.3.1.4.8323329.1594.1517875168.538310.png,/home/dianwen/SIIM_ACR/train/images/1024/mask/1.2.276.0.7230010.3.1.4.8323329.1594.1517875168.538310.png,0.0,0.0,816,1002
1.2.276.0.7230010.3.1.4.8323329.1596.1517875168.530989.png,366759,{},1,0,"{""name"":""rect"",""x"":146,""y"":120,""width"":689,""height"":611}",{},611,rect,689,146,120,/home/dianwen/SIIM_ACR/train/images/1024/dicom/1.2.276.0.7230010.3.1.4.8323329.1596.1517875168.530989.png,/home/dianwen/SIIM_ACR/train/images/1024/mask/1.2.276.0.7230010.3.1.4.8323329.1596.1517875168.530989.png,0.0,0.0,731,835
1.2.276.0.7230010.3.1.4.8323329.1598.1517875168.538782.png,409766,{},1,0,"{""name"":""rect"",""x"":268,""y"":10,""width"":680,""height"":692}",{},692,rect,680,268,10,/home/dianwen/SIIM_ACR/train/images/1024/dicom/1.2.276.0.7230010.3.1.4.8323329.1598.1517875168.538782.png,/home/dianwen/SIIM_ACR/train/images/1024/mask/1.2.276.0.7230010.3.1.4.8323329.1598.1517875168.538782.png,0.0,0.0,702,948
1.2.276.0.7230010.3.1.4.8323329.1599.1517875168.549263.png,404942,{},1,0,"{""name"":""rect"",""x"":8,""y"":123,""width"":939,""height"":895}",{},895,rect,939,8,123,/home/dianwen/SIIM_ACR/train/images/1024/dicom/1.2.276.0.7230010.3.1.4.8323329.1599.1517875168.549263.png,/home/dianwen/SIIM_ACR/train/images/1024/mask/1.2.276.0.7230010.3.1.4.8323329.1599.1517875168.549263.png,0.0,0.0,1018,947
1.2.276.0.7230010.3.1.4.8323329.1600.1517875168.549461.png,360795,{},1,0,"{""name"":""rect"",""x"":101,""y"":51,""width"":706,""height"":941}",{},941,rect,706,101,51,/home/dianwen/SIIM_ACR/train/images/1024/dicom/1.2.276.0.7230010.3.1.4.8323329.1600.1517875168.549461.png,/home/dianwen/SIIM_ACR/train/images/1024/mask/1.2.276.0.7230010.3.1.4.8323329.1600.1517875168.549461.png,0.0,0.0,992,807
1.2.276.0.7230010.3.1.4.8323329.1601.1517875168.546118.png,370081,{},1,0,"{""name"":""rect"",""x"":76,""y"":120,""width"":811,""height"":867}",{},867,rect,811,76,120,/home/dianwen/SIIM_ACR/train/images/1024/dicom/1.2.276.0.7230010.3.1.4.8323329.1601.1517875168.546118.png,/home/dianwen/SIIM_ACR/train/images/1024/mask/1.2.276.0.7230010.3.1.4.8323329.1601.1517875168.546118.png,0.0,0.0,987,887
1.2.276.0.7230010.3.1.4.8323329.1602.1517875168.545257.png,356406,{},1,0,"{""name"":""rect"",""x"":199,""y"":88,""width"":718,""height"":783}",{},783,rect,718,199,88,/home/dianwen/SIIM_ACR/train/images/1024/dicom/1.2.276.0.7230010.3.1.4.8323329.1602.1517875168.545257.png,/home/dianwen/SIIM_ACR/train/images/1024/mask/1.2.276.0.7230010.3.1.4.8323329.1602.1517875168.545257.png,0.0,0.0,871,917
1.2.276.0.7230010.3.1.4.8323329.1603.1517875168.560975.png,366288,{},1,0,"{""name"":""rect"",""x"":67,""y"":49,""width"":904,""height"":822}",{},822,rect,904,67,49,/home/dianwen/SIIM_ACR/train/images/1024/dicom/1.2.276.0.7230010.3.1.4.8323329.1603.1517875168.560975.png,/home/dianwen/SIIM_ACR/train/images/1024/mask/1.2.276.0.7230010.3.1.4.8323329.1603.1517875168.560975.png,0.0,0.0,871,971
1.2.276.0.7230010.3.1.4.8323329.1604.1517875168.558783.png,422608,{},1,0,"{""name"":""rect"",""x"":78,""y"":108,""width"":844,""height"":809}",{},809,rect,844,78,108,/home/dianwen/SIIM_ACR/train/images/1024/dicom/1.2.276.0.7230010.3.1.4.8323329.1604.1517875168.558783.png,/home/dianwen/SIIM_ACR/train/images/1024/mask/1.2.276.0.7230010.3.1.4.8323329.1604.1517875168.558783.png,0.0,0.0,917,922
1.2.276.0.7230010.3.1.4.8323329.1605.1517875168.562776.png,380524,{},1,0,"{""name"":""rect"",""x"":165,""y"":60,""width"":720,""height"":929}",{},929,rect,720,165,60,/home/dianwen/SIIM_ACR/train/images/1024/dicom/1.2.276.0.7230010.3.1.4.8323329.1605.1517875168.562776.png,/home/dianwen/SIIM_ACR/train/images/1024/mask/1.2.276.0.7230010.3.1.4.8323329.1605.1517875168.562776.png,0.0,0.0,989,885
1.2.276.0.7230010.3.1.4.8323329.1606.1517875168.569846.png,425075,{},1,0,"{""name"":""rect"",""x"":3,""y"":71,""width"":890,""height"":811}",{},811,rect,890,3,71,/home/dianwen/SIIM_ACR/train/images/1024/dicom/1.2.276.0.7230010.3.1.4.8323329.1606.1517875168.569846.png,/home/dianwen/SIIM_ACR/train/images/1024/mask/1.2.276.0.7230010.3.1.4.8323329.1606.1517875168.569846.png,0.0,0.0,882,893
1.2.276.0.7230010.3.1.4.8323329.1607.1517875168.570405.png,349649,{},1,0,"{""name"":""rect"",""x"":138,""y"":80,""width"":779,""height"":803}",{},803,rect,779,138,80,/home/dianwen/SIIM_ACR/train/images/1024/dicom/1.2.276.0.7230010.3.1.4.8323329.1607.1517875168.570405.png,/home/dianwen/SIIM_ACR/train/images/1024/mask/1.2.276.0.7230010.3.1.4.8323329.1607.1517875168.570405.png,0.0,0.0,883,917
1.2.276.0.7230010.3.1.4.8323329.1608.1517875168.577144.png,380078,{},1,0,"{""name"":""rect"",""x"":11,""y"":50,""width"":936,""height"":967}",{},967,rect,936,11,50,/home/dianwen/SIIM_ACR/train/images/1024/dicom/1.2.276.0.7230010.3.1.4.8323329.1608.1517875168.577144.png,/home/dianwen/SIIM_ACR/train/images/1024/mask/1.2.276.0.7230010.3.1.4.8323329.1608.1517875168.577144.png,0.0,0.0,1017,947
1.2.276.0.7230010.3.1.4.8323329.1609.1517875168.574978.png,417138,{},1,0,"{""name"":""rect"",""x"":80,""y"":105,""width"":877,""height"":776}",{},776,rect,877,80,105,/home/dianwen/SIIM_ACR/train/images/1024/dicom/1.2.276.0.7230010.3.1.4.8323329.1609.1517875168.574978.png,/home/dianwen/SIIM_ACR/train/images/1024/mask/1.2.276.0.7230010.3.1.4.8323329.1609.1517875168.574978.png,0.0,0.0,881,957
1.2.276.0.7230010.3.1.4.8323329.1610.1517875168.587271.png,417350,{},1,0,"{""name"":""rect"",""x"":141,""y"":86,""width"":777,""height"":787}",{},787,rect,777,141,86,/home/dianwen/SIIM_ACR/train/images/1024/dicom/1.2.276.0.7230010.3.1.4.8323329.1610.1517875168.587271.png,/home/dianwen/SIIM_ACR/train/images/1024/mask/1.2.276.0.7230010.3.1.4.8323329.1610.1517875168.587271.png,0.0071010589599609375,1.0,873,918
1.2.276.0.7230010.3.1.4.8323329.1611.1517875168.586290.png,441290,{},1,0,"{""name"":""rect"",""x"":106,""y"":75,""width"":733,""height"":809}",{},809,rect,733,106,75,/home/dianwen/SIIM_ACR/train/images/1024/dicom/1.2.276.0.7230010.3.1.4.8323329.1611.1517875168.586290.png,/home/dianwen/SIIM_ACR/train/images/1024/mask/1.2.276.0.7230010.3.1.4.8323329.1611.1517875168.586290.png,0.0,0.0,884,839
1.2.276.0.7230010.3.1.4.8323329.1612.1517875168.594239.png,435504,{},1,0,"{""name"":""rect"",""x"":109,""y"":82,""width"":882,""height"":807}",{},807,rect,882,109,82,/home/dianwen/SIIM_ACR/train/images/1024/dicom/1.2.276.0.7230010.3.1.4.8323329.1612.1517875168.594239.png,/home/dianwen/SIIM_ACR/train/images/1024/mask/1.2.276.0.7230010.3.1.4.8323329.1612.1517875168.594239.png,0.0,0.0,889,991
1.2.276.0.7230010.3.1.4.8323329.1613.1517875168.593644.png,316075,{},1,0,"{""name"":""rect"",""x"":219,""y"":68,""width"":795,""height"":809}",{},809,rect,795,219,68,/home/dianwen/SIIM_ACR/train/images/1024/dicom/1.2.276.0.7230010.3.1.4.8323329.1613.1517875168.593644.png,/home/dianwen/SIIM_ACR/train/images/1024/mask/1.2.276.0.7230010.3.1.4.8323329.1613.1517875168.593644.png,0.0,0.0,877,1014
1.2.276.0.7230010.3.1.4.8323329.1614.1517875168.604507.png,444671,{},1,0,"{""name"":""rect"",""x"":168,""y"":59,""width"":672,""height"":656}",{},656,rect,672,168,59,/home/dianwen/SIIM_ACR/train/images/1024/dicom/1.2.276.0.7230010.3.1.4.8323329.1614.1517875168.604507.png,/home/dianwen/SIIM_ACR/train/images/1024/mask/1.2.276.0.7230010.3.1.4.8323329.1614.1517875168.604507.png,0.0,0.0,715,840
1.2.276.0.7230010.3.1.4.8323329.1615.1517875168.605213.png,419443,{},1,0,"{""name"":""rect"",""x"":93,""y"":116,""width"":826,""height"":780}",{},780,rect,826,93,116,/home/dianwen/SIIM_ACR/train/images/1024/dicom/1.2.276.0.7230010.3.1.4.8323329.1615.1517875168.605213.png,/home/dianwen/SIIM_ACR/train/images/1024/mask/1.2.276.0.7230010.3.1.4.8323329.1615.1517875168.605213.png,0.0,0.0,896,919
1.2.276.0.7230010.3.1.4.8323329.1616.1517875168.608627.png,400912,{},1,0,"{""name"":""rect"",""x"":93,""y"":95,""width"":878,""height"":878}",{},878,rect,878,93,95,/home/dianwen/SIIM_ACR/train/images/1024/dicom/1.2.276.0.7230010.3.1.4.8323329.1616.1517875168.608627.png,/home/dianwen/SIIM_ACR/train/images/1024/mask/1.2.276.0.7230010.3.1.4.8323329.1616.1517875168.608627.png,0.003218650817871093,1.0,973,971
1.2.276.0.7230010.3.1.4.8323329.1617.1517875168.608017.png,346942,{},1,0,"{""name"":""rect"",""x"":22,""y"":66,""width"":979,""height"":693}",{},693,rect,979,22,66,/home/dianwen/SIIM_ACR/train/images/1024/dicom/1.2.276.0.7230010.3.1.4.8323329.1617.1517875168.608017.png,/home/dianwen/SIIM_ACR/train/images/1024/mask/1.2.276.0.7230010.3.1.4.8323329.1617.1517875168.608017.png,0.0,0.0,759,1001
1.2.276.0.7230010.3.1.4.8323329.1618.1517875168.600134.png,420927,{},1,0,"{""name"":""rect"",""x"":89,""y"":18,""width"":843,""height"":1005}",{},1005,rect,843,89,18,/home/dianwen/SIIM_ACR/train/images/1024/dicom/1.2.276.0.7230010.3.1.4.8323329.1618.1517875168.600134.png,/home/dianwen/SIIM_ACR/train/images/1024/mask/1.2.276.0.7230010.3.1.4.8323329.1618.1517875168.600134.png,0.0,0.0,1023,932
1.2.276.0.7230010.3.1.4.8323329.1619.1517875168.607812.png,434972,{},1,0,"{""name"":""rect"",""x"":77,""y"":82,""width"":904,""height"":826}",{},826,rect,904,77,82,/home/dianwen/SIIM_ACR/train/images/1024/dicom/1.2.276.0.7230010.3.1.4.8323329.1619.1517875168.607812.png,/home/dianwen/SIIM_ACR/train/images/1024/mask/1.2.276.0.7230010.3.1.4.8323329.1619.1517875168.607812.png,0.0,0.0,908,981
1.2.276.0.7230010.3.1.4.8323329.1620.1517875168.621156.png,376501,{},1,0,"{""name"":""rect"",""x"":151,""y"":102,""width"":745,""height"":895}",{},895,rect,745,151,102,/home/dianwen/SIIM_ACR/train/images/1024/dicom/1.2.276.0.7230010.3.1.4.8323329.1620.1517875168.621156.png,/home/dianwen/SIIM_ACR/train/images/1024/mask/1.2.276.0.7230010.3.1.4.8323329.1620.1517875168.621156.png,0.029280662536621094,1.0,997,896
1.2.276.0.7230010.3.1.4.8323329.1621.1517875168.621676.png,409112,{},1,0,"{""name"":""rect"",""x"":106,""y"":104,""width"":731,""height"":753}",{},753,rect,731,106,104,/home/dianwen/SIIM_ACR/train/images/1024/dicom/1.2.276.0.7230010.3.1.4.8323329.1621.1517875168.621676.png,/home/dianwen/SIIM_ACR/train/images/1024/mask/1.2.276.0.7230010.3.1.4.8323329.1621.1517875168.621676.png,0.0022382736206054688,1.0,857,837
1.2.276.0.7230010.3.1.4.8323329.1622.1517875168.630031.png,387223,{},1,0,"{""name"":""rect"",""x"":41,""y"":205,""width"":861,""height"":818}",{},818,rect,861,41,205,/home/dianwen/SIIM_ACR/train/images/1024/dicom/1.2.276.0.7230010.3.1.4.8323329.1622.1517875168.630031.png,/home/dianwen/SIIM_ACR/train/images/1024/mask/1.2.276.0.7230010.3.1.4.8323329.1622.1517875168.630031.png,0.0,0.0,1023,902
1.2.276.0.7230010.3.1.4.8323329.1623.1517875168.637906.png,403915,{},1,0,"{""name"":""rect"",""x"":147,""y"":227,""width"":817,""height"":692}",{},692,rect,817,147,227,/home/dianwen/SIIM_ACR/train/images/1024/dicom/1.2.276.0.7230010.3.1.4.8323329.1623.1517875168.637906.png,/home/dianwen/SIIM_ACR/train/images/1024/mask/1.2.276.0.7230010.3.1.4.8323329.1623.1517875168.637906.png,0.0,0.0,919,964
1.2.276.0.7230010.3.1.4.8323329.1624.1517875168.636447.png,428297,{},1,0,"{""name"":""rect"",""x"":136,""y"":113,""width"":780,""height"":911}",{},911,rect,780,136,113,/home/dianwen/SIIM_ACR/train/images/1024/dicom/1.2.276.0.7230010.3.1.4.8323329.1624.1517875168.636447.png,/home/dianwen/SIIM_ACR/train/images/1024/mask/1.2.276.0.7230010.3.1.4.8323329.1624.1517875168.636447.png,0.0,0.0,1024,916
1.2.276.0.7230010.3.1.4.8323329.1625.1517875168.637998.png,329308,{},1,0,"{""name"":""rect"",""x"":58,""y"":147,""width"":851,""height"":679}",{},679,rect,851,58,147,/home/dianwen/SIIM_ACR/train/images/1024/dicom/1.2.276.0.7230010.3.1.4.8323329.1625.1517875168.637998.png,/home/dianwen/SIIM_ACR/train/images/1024/mask/1.2.276.0.7230010.3.1.4.8323329.1625.1517875168.637998.png,0.0009765625,1.0,826,909
1.2.276.0.7230010.3.1.4.8323329.1626.1517875168.632174.png,375211,{},1,0,"{""name"":""rect"",""x"":84,""y"":63,""width"":822,""height"":821}",{},821,rect,822,84,63,/home/dianwen/SIIM_ACR/train/images/1024/dicom/1.2.276.0.7230010.3.1.4.8323329.1626.1517875168.632174.png,/home/dianwen/SIIM_ACR/train/images/1024/mask/1.2.276.0.7230010.3.1.4.8323329.1626.1517875168.632174.png,0.01136800181120634,1.0,884,906
1.2.276.0.7230010.3.1.4.8323329.1627.1517875168.640405.png,359395,{},1,0,"{""name"":""rect"",""x"":27,""y"":89,""width"":990,""height"":818}",{},818,rect,990,27,89,/home/dianwen/SIIM_ACR/train/images/1024/dicom/1.2.276.0.7230010.3.1.4.8323329.1627.1517875168.640405.png,/home/dianwen/SIIM_ACR/train/images/1024/mask/1.2.276.0.7230010.3.1.4.8323329.1627.1517875168.640405.png,0.0,0.0,907,1017
1.2.276.0.7230010.3.1.4.8323329.1628.1517875168.635098.png,349912,{},1,0,"{""name"":""rect"",""x"":82,""y"":155,""width"":788,""height"":758}",{},758,rect,788,82,155,/home/dianwen/SIIM_ACR/train/images/1024/dicom/1.2.276.0.7230010.3.1.4.8323329.1628.1517875168.635098.png,/home/dianwen/SIIM_ACR/train/images/1024/mask/1.2.276.0.7230010.3.1.4.8323329.1628.1517875168.635098.png,0.0,0.0,913,870
1.2.276.0.7230010.3.1.4.8323329.1629.1517875168.649997.png,430716,{},1,0,"{""name"":""rect"",""x"":125,""y"":116,""width"":835,""height"":824}",{},824,rect,835,125,116,/home/dianwen/SIIM_ACR/train/images/1024/dicom/1.2.276.0.7230010.3.1.4.8323329.1629.1517875168.649997.png,/home/dianwen/SIIM_ACR/train/images/1024/mask/1.2.276.0.7230010.3.1.4.8323329.1629.1517875168.649997.png,0.0,0.0,940,960
1.2.276.0.7230010.3.1.4.8323329.1630.1517875168.649612.png,390592,{},1,0,"{""name"":""rect"",""x"":26,""y"":43,""width"":920,""height"":981}",{},981,rect,920,26,43,/home/dianwen/SIIM_ACR/train/images/1024/dicom/1.2.276.0.7230010.3.1.4.8323329.1630.1517875168.649612.png,/home/dianwen/SIIM_ACR/train/images/1024/mask/1.2.276.0.7230010.3.1.4.8323329.1630.1517875168.649612.png,0.0,0.0,1024,946
1.2.276.0.7230010.3.1.4.8323329.1631.1517875168.653719.png,361611,{},1,0,"{""name"":""rect"",""x"":80,""y"":121,""width"":944,""height"":903}",{},903,rect,944,80,121,/home/dianwen/SIIM_ACR/train/images/1024/dicom/1.2.276.0.7230010.3.1.4.8323329.1631.1517875168.653719.png,/home/dianwen/SIIM_ACR/train/images/1024/mask/1.2.276.0.7230010.3.1.4.8323329.1631.1517875168.653719.png,0.0,0.0,1024,1024
1.2.276.0.7230010.3.1.4.8323329.1632.1517875168.659322.png,389654,{},1,0,"{""name"":""rect"",""x"":119,""y"":86,""width"":732,""height"":783}",{},783,rect,732,119,86,/home/dianwen/SIIM_ACR/train/images/1024/dicom/1.2.276.0.7230010.3.1.4.8323329.1632.1517875168.659322.png,/home/dianwen/SIIM_ACR/train/images/1024/mask/1.2.276.0.7230010.3.1.4.8323329.1632.1517875168.659322.png,0.005533218383789063,1.0,869,851
1.2.276.0.7230010.3.1.4.8323329.1633.1517875168.663178.png,372456,{},1,0,"{""name"":""rect"",""x"":63,""y"":77,""width"":921,""height"":947}",{},947,rect,921,63,77,/home/dianwen/SIIM_ACR/train/images/1024/dicom/1.2.276.0.7230010.3.1.4.8323329.1633.1517875168.663178.png,/home/dianwen/SIIM_ACR/train/images/1024/mask/1.2.276.0.7230010.3.1.4.8323329.1633.1517875168.663178.png,0.0,0.0,1024,984
1.2.276.0.7230010.3.1.4.8323329.1634.1517875168.664242.png,401957,{},1,0,"{""name"":""rect"",""x"":143,""y"":110,""width"":811,""height"":736}",{},736,rect,811,143,110,/home/dianwen/SIIM_ACR/train/images/1024/dicom/1.2.276.0.7230010.3.1.4.8323329.1634.1517875168.664242.png,/home/dianwen/SIIM_ACR/train/images/1024/mask/1.2.276.0.7230010.3.1.4.8323329.1634.1517875168.664242.png,0.0,0.0,846,954
1.2.276.0.7230010.3.1.4.8323329.1635.1517875168.672171.png,415505,{},1,0,"{""name"":""rect"",""x"":137,""y"":5,""width"":720,""height"":700}",{},700,rect,720,137,5,/home/dianwen/SIIM_ACR/train/images/1024/dicom/1.2.276.0.7230010.3.1.4.8323329.1635.1517875168.672171.png,/home/dianwen/SIIM_ACR/train/images/1024/mask/1.2.276.0.7230010.3.1.4.8323329.1635.1517875168.672171.png,0.0,0.0,705,857
1.2.276.0.7230010.3.1.4.8323329.1636.1517875168.675520.png,424499,{},1,0,"{""name"":""rect"",""x"":105,""y"":91,""width"":827,""height"":737}",{},737,rect,827,105,91,/home/dianwen/SIIM_ACR/train/images/1024/dicom/1.2.276.0.7230010.3.1.4.8323329.1636.1517875168.675520.png,/home/dianwen/SIIM_ACR/train/images/1024/mask/1.2.276.0.7230010.3.1.4.8323329.1636.1517875168.675520.png,0.0,0.0,828,932
1.2.276.0.7230010.3.1.4.8323329.1637.1517875168.681016.png,365264,{},1,0,"{""name"":""rect"",""x"":44,""y"":82,""width"":879,""height"":763}",{},763,rect,879,44,82,/home/dianwen/SIIM_ACR/train/images/1024/dicom/1.2.276.0.7230010.3.1.4.8323329.1637.1517875168.681016.png,/home/dianwen/SIIM_ACR/train/images/1024/mask/1.2.276.0.7230010.3.1.4.8323329.1637.1517875168.681016.png,0.01568947173655033,1.0,845,923
1.2.276.0.7230010.3.1.4.8323329.1638.1517875168.689848.png,433024,{},1,0,"{""name"":""rect"",""x"":164,""y"":74,""width"":818,""height"":788}",{},788,rect,818,164,74,/home/dianwen/SIIM_ACR/train/images/1024/dicom/1.2.276.0.7230010.3.1.4.8323329.1638.1517875168.689848.png,/home/dianwen/SIIM_ACR/train/images/1024/mask/1.2.276.0.7230010.3.1.4.8323329.1638.1517875168.689848.png,0.014544486999511719,1.0,862,982
1.2.276.0.7230010.3.1.4.8323329.1639.1517875168.701772.png,329901,{},1,0,"{""name"":""rect"",""x"":55,""y"":182,""width"":716,""height"":706}",{},706,rect,716,55,182,/home/dianwen/SIIM_ACR/train/images/1024/dicom/1.2.276.0.7230010.3.1.4.8323329.1639.1517875168.701772.png,/home/dianwen/SIIM_ACR/train/images/1024/mask/1.2.276.0.7230010.3.1.4.8323329.1639.1517875168.701772.png,0.0,0.0,888,771
1.2.276.0.7230010.3.1.4.8323329.1640.1517875168.702472.png,329991,{},1,0,"{""name"":""rect"",""x"":244,""y"":156,""width"":681,""height"":736}",{},736,rect,681,244,156,/home/dianwen/SIIM_ACR/train/images/1024/dicom/1.2.276.0.7230010.3.1.4.8323329.1640.1517875168.702472.png,/home/dianwen/SIIM_ACR/train/images/1024/mask/1.2.276.0.7230010.3.1.4.8323329.1640.1517875168.702472.png,0.0,0.0,892,925
1.2.276.0.7230010.3.1.4.8323329.1641.1517875168.710796.png,450483,{},1,0,"{""name"":""rect"",""x"":74,""y"":19,""width"":865,""height"":846}",{},846,rect,865,74,19,/home/dianwen/SIIM_ACR/train/images/1024/dicom/1.2.276.0.7230010.3.1.4.8323329.1641.1517875168.710796.png,/home/dianwen/SIIM_ACR/train/images/1024/mask/1.2.276.0.7230010.3.1.4.8323329.1641.1517875168.710796.png,0.006838798522949219,1.0,865,939
1.2.276.0.7230010.3.1.4.8323329.1642.1517875168.705407.png,234954,{},1,0,"{""name"":""rect"",""x"":283,""y"":221,""width"":625,""height"":485}",{},485,rect,625,283,221,/home/dianwen/SIIM_ACR/train/images/1024/dicom/1.2.276.0.7230010.3.1.4.8323329.1642.1517875168.705407.png,/home/dianwen/SIIM_ACR/train/images/1024/mask/1.2.276.0.7230010.3.1.4.8323329.1642.1517875168.705407.png,0.0,0.0,706,908
1.2.276.0.7230010.3.1.4.8323329.1643.1517875168.714981.png,398001,{},1,0,"{""name"":""rect"",""x"":93,""y"":177,""width"":752,""height"":847}",{},847,rect,752,93,177,/home/dianwen/SIIM_ACR/train/images/1024/dicom/1.2.276.0.7230010.3.1.4.8323329.1643.1517875168.714981.png,/home/dianwen/SIIM_ACR/train/images/1024/mask/1.2.276.0.7230010.3.1.4.8323329.1643.1517875168.714981.png,0.003021240234375,1.0,1024,845
1.2.276.0.7230010.3.1.4.8323329.1644.1517875168.720240.png,428963,{},1,0,"{""name"":""rect"",""x"":165,""y"":131,""width"":852,""height"":702}",{},702,rect,852,165,131,/home/dianwen/SIIM_ACR/train/images/1024/dicom/1.2.276.0.7230010.3.1.4.8323329.1644.1517875168.720240.png,/home/dianwen/SIIM_ACR/train/images/1024/mask/1.2.276.0.7230010.3.1.4.8323329.1644.1517875168.720240.png,0.017632484436035156,1.0,833,1017
1.2.276.0.7230010.3.1.4.8323329.1645.1517875168.725282.png,432160,{},1,0,"{""name"":""rect"",""x"":131,""y"":135,""width"":821,""height"":802}",{},802,rect,821,131,135,/home/dianwen/SIIM_ACR/train/images/1024/dicom/1.2.276.0.7230010.3.1.4.8323329.1645.1517875168.725282.png,/home/dianwen/SIIM_ACR/train/images/1024/mask/1.2.276.0.7230010.3.1.4.8323329.1645.1517875168.725282.png,0.0,0.0,937,952
1.2.276.0.7230010.3.1.4.8323329.1646.1517875168.729252.png,385512,{},1,0,"{""name"":""rect"",""x"":174,""y"":140,""width"":741,""height"":637}",{},637,rect,741,174,140,/home/dianwen/SIIM_ACR/train/images/1024/dicom/1.2.276.0.7230010.3.1.4.8323329.1646.1517875168.729252.png,/home/dianwen/SIIM_ACR/train/images/1024/mask/1.2.276.0.7230010.3.1.4.8323329.1646.1517875168.729252.png,0.0,0.0,777,915
1.2.276.0.7230010.3.1.4.8323329.1647.1517875168.733165.png,295967,{},1,0,"{""name"":""rect"",""x"":68,""y"":74,""width"":803,""height"":689}",{},689,rect,803,68,74,/home/dianwen/SIIM_ACR/train/images/1024/dicom/1.2.276.0.7230010.3.1.4.8323329.1647.1517875168.733165.png,/home/dianwen/SIIM_ACR/train/images/1024/mask/1.2.276.0.7230010.3.1.4.8323329.1647.1517875168.733165.png,0.004895210266113281,1.0,763,871
1.2.276.0.7230010.3.1.4.8323329.1648.1517875168.738108.png,384160,{},1,0,"{""name"":""rect"",""x"":159,""y"":80,""width"":693,""height"":791}",{},791,rect,693,159,80,/home/dianwen/SIIM_ACR/train/images/1024/dicom/1.2.276.0.7230010.3.1.4.8323329.1648.1517875168.738108.png,/home/dianwen/SIIM_ACR/train/images/1024/mask/1.2.276.0.7230010.3.1.4.8323329.1648.1517875168.738108.png,0.006547927856445313,1.0,871,852
1.2.276.0.7230010.3.1.4.8323329.1650.1517875168.754014.png,293408,{},1,0,"{""name"":""rect"",""x"":100,""y"":296,""width"":729,""height"":725}",{},725,rect,729,100,296,/home/dianwen/SIIM_ACR/train/images/1024/dicom/1.2.276.0.7230010.3.1.4.8323329.1650.1517875168.754014.png,/home/dianwen/SIIM_ACR/train/images/1024/mask/1.2.276.0.7230010.3.1.4.8323329.1650.1517875168.754014.png,0.0,0.0,1021,829
1.2.276.0.7230010.3.1.4.8323329.1651.1517875168.752460.png,456333,{},1,0,"{""name"":""rect"",""x"":43,""y"":79,""width"":957,""height"":774}",{},774,rect,957,43,79,/home/dianwen/SIIM_ACR/train/images/1024/dicom/1.2.276.0.7230010.3.1.4.8323329.1651.1517875168.752460.png,/home/dianwen/SIIM_ACR/train/images/1024/mask/1.2.276.0.7230010.3.1.4.8323329.1651.1517875168.752460.png,0.03377819061279297,1.0,853,1000
1.2.276.0.7230010.3.1.4.8323329.1652.1517875168.768278.png,378016,{},1,0,"{""name"":""rect"",""x"":185,""y"":134,""width"":650,""height"":570}",{},570,rect,650,185,134,/home/dianwen/SIIM_ACR/train/images/1024/dicom/1.2.276.0.7230010.3.1.4.8323329.1652.1517875168.768278.png,/home/dianwen/SIIM_ACR/train/images/1024/mask/1.2.276.0.7230010.3.1.4.8323329.1652.1517875168.768278.png,0.0,0.0,704,835
1.2.276.0.7230010.3.1.4.8323329.1653.1517875168.768725.png,370565,{},1,0,"{""name"":""rect"",""x"":119,""y"":108,""width"":778,""height"":718}",{},718,rect,778,119,108,/home/dianwen/SIIM_ACR/train/images/1024/dicom/1.2.276.0.7230010.3.1.4.8323329.1653.1517875168.768725.png,/home/dianwen/SIIM_ACR/train/images/1024/mask/1.2.276.0.7230010.3.1.4.8323329.1653.1517875168.768725.png,0.003430366516113281,1.0,826,897
1.2.276.0.7230010.3.1.4.8323329.1654.1517875168.763844.png,384540,{},1,0,"{""name"":""rect"",""x"":117,""y"":143,""width"":742,""height"":808}",{},808,rect,742,117,143,/home/dianwen/SIIM_ACR/train/images/1024/dicom/1.2.276.0.7230010.3.1.4.8323329.1654.1517875168.763844.png,/home/dianwen/SIIM_ACR/train/images/1024/mask/1.2.276.0.7230010.3.1.4.8323329.1654.1517875168.763844.png,0.0,0.0,951,859
1.2.276.0.7230010.3.1.4.8323329.1655.1517875168.771407.png,389251,{},1,0,"{""name"":""rect"",""x"":104,""y"":46,""width"":895,""height"":907}",{},907,rect,895,104,46,/home/dianwen/SIIM_ACR/train/images/1024/dicom/1.2.276.0.7230010.3.1.4.8323329.1655.1517875168.771407.png,/home/dianwen/SIIM_ACR/train/images/1024/mask/1.2.276.0.7230010.3.1.4.8323329.1655.1517875168.771407.png,0.0,0.0,953,999
1.2.276.0.7230010.3.1.4.8323329.1656.1517875168.772968.png,440921,{},1,0,"{""name"":""rect"",""x"":79,""y"":107,""width"":855,""height"":844}",{},844,rect,855,79,107,/home/dianwen/SIIM_ACR/train/images/1024/dicom/1.2.276.0.7230010.3.1.4.8323329.1656.1517875168.772968.png,/home/dianwen/SIIM_ACR/train/images/1024/mask/1.2.276.0.7230010.3.1.4.8323329.1656.1517875168.772968.png,0.0,0.0,951,934
1.2.276.0.7230010.3.1.4.8323329.1657.1517875168.785023.png,336751,{},1,0,"{""name"":""rect"",""x"":74,""y"":125,""width"":834,""height"":750}",{},750,rect,834,74,125,/home/dianwen/SIIM_ACR/train/images/1024/dicom/1.2.276.0.7230010.3.1.4.8323329.1657.1517875168.785023.png,/home/dianwen/SIIM_ACR/train/images/1024/mask/1.2.276.0.7230010.3.1.4.8323329.1657.1517875168.785023.png,0.0,0.0,875,908
1.2.276.0.7230010.3.1.4.8323329.1658.1517875168.791095.png,449614,{},1,0,"{""name"":""rect"",""x"":168,""y"":82,""width"":836,""height"":829}",{},829,rect,836,168,82,/home/dianwen/SIIM_ACR/train/images/1024/dicom/1.2.276.0.7230010.3.1.4.8323329.1658.1517875168.791095.png,/home/dianwen/SIIM_ACR/train/images/1024/mask/1.2.276.0.7230010.3.1.4.8323329.1658.1517875168.791095.png,0.0,0.0,911,1004
1.2.276.0.7230010.3.1.4.8323329.1659.1517875168.790062.png,358736,{},1,0,"{""name"":""rect"",""x"":29,""y"":55,""width"":908,""height"":793}",{},793,rect,908,29,55,/home/dianwen/SIIM_ACR/train/images/1024/dicom/1.2.276.0.7230010.3.1.4.8323329.1659.1517875168.790062.png,/home/dianwen/SIIM_ACR/train/images/1024/mask/1.2.276.0.7230010.3.1.4.8323329.1659.1517875168.790062.png,0.0,0.0,848,937
1.2.276.0.7230010.3.1.4.8323329.1660.1517875168.792780.png,384707,{},1,0,"{""name"":""rect"",""x"":158,""y"":94,""width"":638,""height"":777}",{},777,rect,638,158,94,/home/dianwen/SIIM_ACR/train/images/1024/dicom/1.2.276.0.7230010.3.1.4.8323329.1660.1517875168.792780.png,/home/dianwen/SIIM_ACR/train/images/1024/mask/1.2.276.0.7230010.3.1.4.8323329.1660.1517875168.792780.png,0.0,0.0,871,796
1.2.276.0.7230010.3.1.4.8323329.1661.1517875168.798873.png,419567,{},1,0,"{""name"":""rect"",""x"":104,""y"":125,""width"":794,""height"":664}",{},664,rect,794,104,125,/home/dianwen/SIIM_ACR/train/images/1024/dicom/1.2.276.0.7230010.3.1.4.8323329.1661.1517875168.798873.png,/home/dianwen/SIIM_ACR/train/images/1024/mask/1.2.276.0.7230010.3.1.4.8323329.1661.1517875168.798873.png,0.0,0.0,789,898
1.2.276.0.7230010.3.1.4.8323329.1662.1517875168.798166.png,286763,{},1,0,"{""name"":""rect"",""x"":84,""y"":87,""width"":828,""height"":824}",{},824,rect,828,84,87,/home/dianwen/SIIM_ACR/train/images/1024/dicom/1.2.276.0.7230010.3.1.4.8323329.1662.1517875168.798166.png,/home/dianwen/SIIM_ACR/train/images/1024/mask/1.2.276.0.7230010.3.1.4.8323329.1662.1517875168.798166.png,0.0,0.0,911,912
1.2.276.0.7230010.3.1.4.8323329.1663.1517875168.814856.png,330906,{},1,0,"{""name"":""rect"",""x"":137,""y"":87,""width"":733,""height"":887}",{},887,rect,733,137,87,/home/dianwen/SIIM_ACR/train/images/1024/dicom/1.2.276.0.7230010.3.1.4.8323329.1663.1517875168.814856.png,/home/dianwen/SIIM_ACR/train/images/1024/mask/1.2.276.0.7230010.3.1.4.8323329.1663.1517875168.814856.png,0.0,0.0,974,870
1.2.276.0.7230010.3.1.4.8323329.1664.1517875168.814209.png,311780,{},1,0,"{""name"":""rect"",""x"":145,""y"":95,""width"":748,""height"":722}",{},722,rect,748,145,95,/home/dianwen/SIIM_ACR/train/images/1024/dicom/1.2.276.0.7230010.3.1.4.8323329.1664.1517875168.814209.png,/home/dianwen/SIIM_ACR/train/images/1024/mask/1.2.276.0.7230010.3.1.4.8323329.1664.1517875168.814209.png,0.0,0.0,817,893
1.2.276.0.7230010.3.1.4.8323329.1665.1517875168.814837.png,367398,{},1,0,"{""name"":""rect"",""x"":147,""y"":95,""width"":847,""height"":718}",{},718,rect,847,147,95,/home/dianwen/SIIM_ACR/train/images/1024/dicom/1.2.276.0.7230010.3.1.4.8323329.1665.1517875168.814837.png,/home/dianwen/SIIM_ACR/train/images/1024/mask/1.2.276.0.7230010.3.1.4.8323329.1665.1517875168.814837.png,0.0,0.0,813,994
1.2.276.0.7230010.3.1.4.8323329.1666.1517875168.835418.png,397228,{},1,0,"{""name"":""rect"",""x"":119,""y"":98,""width"":782,""height"":698}",{},698,rect,782,119,98,/home/dianwen/SIIM_ACR/train/images/1024/dicom/1.2.276.0.7230010.3.1.4.8323329.1666.1517875168.835418.png,/home/dianwen/SIIM_ACR/train/images/1024/mask/1.2.276.0.7230010.3.1.4.8323329.1666.1517875168.835418.png,0.0,0.0,796,901
1.2.276.0.7230010.3.1.4.8323329.1667.1517875168.835418.png,408214,{},1,0,"{""name"":""rect"",""x"":182,""y"":46,""width"":708,""height"":769}",{},769,rect,708,182,46,/home/dianwen/SIIM_ACR/train/images/1024/dicom/1.2.276.0.7230010.3.1.4.8323329.1667.1517875168.835418.png,/home/dianwen/SIIM_ACR/train/images/1024/mask/1.2.276.0.7230010.3.1.4.8323329.1667.1517875168.835418.png,0.006323032546788454,1.0,815,890
1.2.276.0.7230010.3.1.4.8323329.1668.1517875168.835418.png,399300,{},1,0,"{""name"":""rect"",""x"":2,""y"":117,""width"":1005,""height"":699}",{},699,rect,1005,2,117,/home/dianwen/SIIM_ACR/train/images/1024/dicom/1.2.276.0.7230010.3.1.4.8323329.1668.1517875168.835418.png,/home/dianwen/SIIM_ACR/train/images/1024/mask/1.2.276.0.7230010.3.1.4.8323329.1668.1517875168.835418.png,0.0,0.0,816,1007
1.2.276.0.7230010.3.1.4.8323329.1669.1517875168.837321.png,301125,{},1,0,"{""name"":""rect"",""x"":102,""y"":174,""width"":763,""height"":826}",{},826,rect,763,102,174,/home/dianwen/SIIM_ACR/train/images/1024/dicom/1.2.276.0.7230010.3.1.4.8323329.1669.1517875168.837321.png,/home/dianwen/SIIM_ACR/train/images/1024/mask/1.2.276.0.7230010.3.1.4.8323329.1669.1517875168.837321.png,0.0,0.0,1000,865
1.2.276.0.7230010.3.1.4.8323329.1670.1517875168.841822.png,382158,{},1,0,"{""name"":""rect"",""x"":58,""y"":89,""width"":965,""height"":809}",{},809,rect,965,58,89,/home/dianwen/SIIM_ACR/train/images/1024/dicom/1.2.276.0.7230010.3.1.4.8323329.1670.1517875168.841822.png,/home/dianwen/SIIM_ACR/train/images/1024/mask/1.2.276.0.7230010.3.1.4.8323329.1670.1517875168.841822.png,0.0,0.0,898,1023
1.2.276.0.7230010.3.1.4.8323329.1671.1517875168.859238.png,435565,{},1,0,"{""name"":""rect"",""x"":99,""y"":51,""width"":763,""height"":643}",{},643,rect,763,99,51,/home/dianwen/SIIM_ACR/train/images/1024/dicom/1.2.276.0.7230010.3.1.4.8323329.1671.1517875168.859238.png,/home/dianwen/SIIM_ACR/train/images/1024/mask/1.2.276.0.7230010.3.1.4.8323329.1671.1517875168.859238.png,0.0,0.0,694,862
1.2.276.0.7230010.3.1.4.8323329.1672.1517875168.860940.png,377463,{},1,0,"{""name"":""rect"",""x"":130,""y"":85,""width"":831,""height"":813}",{},813,rect,831,130,85,/home/dianwen/SIIM_ACR/train/images/1024/dicom/1.2.276.0.7230010.3.1.4.8323329.1672.1517875168.860940.png,/home/dianwen/SIIM_ACR/train/images/1024/mask/1.2.276.0.7230010.3.1.4.8323329.1672.1517875168.860940.png,0.0,0.0,898,961
1.2.276.0.7230010.3.1.4.8323329.1673.1517875168.869236.png,455704,{},1,0,"{""name"":""rect"",""x"":36,""y"":66,""width"":810,""height"":941}",{},941,rect,810,36,66,/home/dianwen/SIIM_ACR/train/images/1024/dicom/1.2.276.0.7230010.3.1.4.8323329.1673.1517875168.869236.png,/home/dianwen/SIIM_ACR/train/images/1024/mask/1.2.276.0.7230010.3.1.4.8323329.1673.1517875168.869236.png,0.021889686584472656,1.0,1007,846
1.2.276.0.7230010.3.1.4.8323329.1674.1517875168.871683.png,383318,{},1,0,"{""name"":""rect"",""x"":126,""y"":120,""width"":790,""height"":820}",{},820,rect,790,126,120,/home/dianwen/SIIM_ACR/train/images/1024/dicom/1.2.276.0.7230010.3.1.4.8323329.1674.1517875168.871683.png,/home/dianwen/SIIM_ACR/train/images/1024/mask/1.2.276.0.7230010.3.1.4.8323329.1674.1517875168.871683.png,0.0,0.0,940,916
1.2.276.0.7230010.3.1.4.8323329.1675.1517875168.870209.png,431213,{},1,0,"{""name"":""rect"",""x"":126,""y"":121,""width"":835,""height"":693}",{},693,rect,835,126,121,/home/dianwen/SIIM_ACR/train/images/1024/dicom/1.2.276.0.7230010.3.1.4.8323329.1675.1517875168.870209.png,/home/dianwen/SIIM_ACR/train/images/1024/mask/1.2.276.0.7230010.3.1.4.8323329.1675.1517875168.870209.png,0.0,0.0,814,961
1.2.276.0.7230010.3.1.4.8323329.1676.1517875168.871500.png,450510,{},1,0,"{""name"":""rect"",""x"":66,""y"":65,""width"":887,""height"":936}",{},936,rect,887,66,65,/home/dianwen/SIIM_ACR/train/images/1024/dicom/1.2.276.0.7230010.3.1.4.8323329.1676.1517875168.871500.png,/home/dianwen/SIIM_ACR/train/images/1024/mask/1.2.276.0.7230010.3.1.4.8323329.1676.1517875168.871500.png,0.0,0.0,1001,953
1.2.276.0.7230010.3.1.4.8323329.1677.1517875168.880742.png,358680,{},1,0,"{""name"":""rect"",""x"":13,""y"":180,""width"":993,""height"":743}",{},743,rect,993,13,180,/home/dianwen/SIIM_ACR/train/images/1024/dicom/1.2.276.0.7230010.3.1.4.8323329.1677.1517875168.880742.png,/home/dianwen/SIIM_ACR/train/images/1024/mask/1.2.276.0.7230010.3.1.4.8323329.1677.1517875168.880742.png,0.005003929138183594,1.0,923,1006
1.2.276.0.7230010.3.1.4.8323329.1678.1517875168.880587.png,388298,{},1,0,"{""name"":""rect"",""x"":112,""y"":124,""width"":844,""height"":692}",{},692,rect,844,112,124,/home/dianwen/SIIM_ACR/train/images/1024/dicom/1.2.276.0.7230010.3.1.4.8323329.1678.1517875168.880587.png,/home/dianwen/SIIM_ACR/train/images/1024/mask/1.2.276.0.7230010.3.1.4.8323329.1678.1517875168.880587.png,0.0,0.0,816,956
1.2.276.0.7230010.3.1.4.8323329.1679.1517875168.896174.png,372393,{},1,0,"{""name"":""rect"",""x"":91,""y"":133,""width"":872,""height"":709}",{},709,rect,872,91,133,/home/dianwen/SIIM_ACR/train/images/1024/dicom/1.2.276.0.7230010.3.1.4.8323329.1679.1517875168.896174.png,/home/dianwen/SIIM_ACR/train/images/1024/mask/1.2.276.0.7230010.3.1.4.8323329.1679.1517875168.896174.png,0.0,0.0,842,963
1.2.276.0.7230010.3.1.4.8323329.1680.1517875168.892927.png,430159,{},1,0,"{""name"":""rect"",""x"":34,""y"":143,""width"":899,""height"":840}",{},840,rect,899,34,143,/home/dianwen/SIIM_ACR/train/images/1024/dicom/1.2.276.0.7230010.3.1.4.8323329.1680.1517875168.892927.png,/home/dianwen/SIIM_ACR/train/images/1024/mask/1.2.276.0.7230010.3.1.4.8323329.1680.1517875168.892927.png,0.0,0.0,983,933
1.2.276.0.7230010.3.1.4.8323329.1681.1517875168.896209.png,301131,{},1,0,"{""name"":""rect"",""x"":170,""y"":112,""width"":829,""height"":710}",{},710,rect,829,170,112,/home/dianwen/SIIM_ACR/train/images/1024/dicom/1.2.276.0.7230010.3.1.4.8323329.1681.1517875168.896209.png,/home/dianwen/SIIM_ACR/train/images/1024/mask/1.2.276.0.7230010.3.1.4.8323329.1681.1517875168.896209.png,0.0,0.0,822,999
1.2.276.0.7230010.3.1.4.8323329.1682.1517875168.902631.png,396324,{},1,0,"{""name"":""rect"",""x"":91,""y"":68,""width"":931,""height"":824}",{},824,rect,931,91,68,/home/dianwen/SIIM_ACR/train/images/1024/dicom/1.2.276.0.7230010.3.1.4.8323329.1682.1517875168.902631.png,/home/dianwen/SIIM_ACR/train/images/1024/mask/1.2.276.0.7230010.3.1.4.8323329.1682.1517875168.902631.png,0.0,0.0,892,1022
1.2.276.0.7230010.3.1.4.8323329.1683.1517875168.913340.png,347087,{},1,0,"{""name"":""rect"",""x"":113,""y"":102,""width"":784,""height"":912}",{},912,rect,784,113,102,/home/dianwen/SIIM_ACR/train/images/1024/dicom/1.2.276.0.7230010.3.1.4.8323329.1683.1517875168.913340.png,/home/dianwen/SIIM_ACR/train/images/1024/mask/1.2.276.0.7230010.3.1.4.8323329.1683.1517875168.913340.png,0.0,0.0,1014,897
1.2.276.0.7230010.3.1.4.8323329.1684.1517875168.914509.png,386148,{},1,0,"{""name"":""rect"",""x"":87,""y"":84,""width"":750,""height"":886}",{},886,rect,750,87,84,/home/dianwen/SIIM_ACR/train/images/1024/dicom/1.2.276.0.7230010.3.1.4.8323329.1684.1517875168.914509.png,/home/dianwen/SIIM_ACR/train/images/1024/mask/1.2.276.0.7230010.3.1.4.8323329.1684.1517875168.914509.png,0.0,0.0,970,837
1.2.276.0.7230010.3.1.4.8323329.1685.1517875168.916501.png,378605,{},1,0,"{""name"":""rect"",""x"":225,""y"":105,""width"":642,""height"":761}",{},761,rect,642,225,105,/home/dianwen/SIIM_ACR/train/images/1024/dicom/1.2.276.0.7230010.3.1.4.8323329.1685.1517875168.916501.png,/home/dianwen/SIIM_ACR/train/images/1024/mask/1.2.276.0.7230010.3.1.4.8323329.1685.1517875168.916501.png,0.0,0.0,866,867
1.2.276.0.7230010.3.1.4.8323329.1686.1517875168.924189.png,430785,{},1,0,"{""name"":""rect"",""x"":67,""y"":74,""width"":842,""height"":776}",{},776,rect,842,67,74,/home/dianwen/SIIM_ACR/train/images/1024/dicom/1.2.276.0.7230010.3.1.4.8323329.1686.1517875168.924189.png,/home/dianwen/SIIM_ACR/train/images/1024/mask/1.2.276.0.7230010.3.1.4.8323329.1686.1517875168.924189.png,0.0,0.0,850,909
1.2.276.0.7230010.3.1.4.8323329.1687.1517875168.927708.png,290959,{},1,0,"{""name"":""rect"",""x"":257,""y"":185,""width"":767,""height"":740}",{},740,rect,767,257,185,/home/dianwen/SIIM_ACR/train/images/1024/dicom/1.2.276.0.7230010.3.1.4.8323329.1687.1517875168.927708.png,/home/dianwen/SIIM_ACR/train/images/1024/mask/1.2.276.0.7230010.3.1.4.8323329.1687.1517875168.927708.png,0.0,0.0,925,1024
1.2.276.0.7230010.3.1.4.8323329.1688.1517875168.934325.png,355764,{},1,0,"{""name"":""rect"",""x"":100,""y"":62,""width"":837,""height"":941}",{},941,rect,837,100,62,/home/dianwen/SIIM_ACR/train/images/1024/dicom/1.2.276.0.7230010.3.1.4.8323329.1688.1517875168.934325.png,/home/dianwen/SIIM_ACR/train/images/1024/mask/1.2.276.0.7230010.3.1.4.8323329.1688.1517875168.934325.png,0.0,0.0,1003,937
1.2.276.0.7230010.3.1.4.8323329.1689.1517875168.936106.png,408378,{},1,0,"{""name"":""rect"",""x"":61,""y"":127,""width"":820,""height"":799}",{},799,rect,820,61,127,/home/dianwen/SIIM_ACR/train/images/1024/dicom/1.2.276.0.7230010.3.1.4.8323329.1689.1517875168.936106.png,/home/dianwen/SIIM_ACR/train/images/1024/mask/1.2.276.0.7230010.3.1.4.8323329.1689.1517875168.936106.png,0.0,0.0,926,881
1.2.276.0.7230010.3.1.4.8323329.1690.1517875168.958183.png,387056,{},1,0,"{""name"":""rect"",""x"":256,""y"":140,""width"":688,""height"":722}",{},722,rect,688,256,140,/home/dianwen/SIIM_ACR/train/images/1024/dicom/1.2.276.0.7230010.3.1.4.8323329.1690.1517875168.958183.png,/home/dianwen/SIIM_ACR/train/images/1024/mask/1.2.276.0.7230010.3.1.4.8323329.1690.1517875168.958183.png,0.0074672698974609375,1.0,862,944
1.2.276.0.7230010.3.1.4.8323329.1691.1517875168.958968.png,368321,{},1,0,"{""name"":""rect"",""x"":163,""y"":74,""width"":648,""height"":756}",{},756,rect,648,163,74,/home/dianwen/SIIM_ACR/train/images/1024/dicom/1.2.276.0.7230010.3.1.4.8323329.1691.1517875168.958968.png,/home/dianwen/SIIM_ACR/train/images/1024/mask/1.2.276.0.7230010.3.1.4.8323329.1691.1517875168.958968.png,0.0,0.0,830,811
1.2.276.0.7230010.3.1.4.8323329.1692.1517875168.961258.png,327805,{},1,0,"{""name"":""rect"",""x"":124,""y"":158,""width"":701,""height"":754}",{},754,rect,701,124,158,/home/dianwen/SIIM_ACR/train/images/1024/dicom/1.2.276.0.7230010.3.1.4.8323329.1692.1517875168.961258.png,/home/dianwen/SIIM_ACR/train/images/1024/mask/1.2.276.0.7230010.3.1.4.8323329.1692.1517875168.961258.png,0.002292633056640625,1.0,912,825
1.2.276.0.7230010.3.1.4.8323329.1693.1517875168.977010.png,407947,{},1,0,"{""name"":""rect"",""x"":109,""y"":109,""width"":846,""height"":760}",{},760,rect,846,109,109,/home/dianwen/SIIM_ACR/train/images/1024/dicom/1.2.276.0.7230010.3.1.4.8323329.1693.1517875168.977010.png,/home/dianwen/SIIM_ACR/train/images/1024/mask/1.2.276.0.7230010.3.1.4.8323329.1693.1517875168.977010.png,0.0,0.0,869,955
1.2.276.0.7230010.3.1.4.8323329.1694.1517875168.978681.png,390038,{},1,0,"{""name"":""rect"",""x"":65,""y"":53,""width"":810,""height"":971}",{},971,rect,810,65,53,/home/dianwen/SIIM_ACR/train/images/1024/dicom/1.2.276.0.7230010.3.1.4.8323329.1694.1517875168.978681.png,/home/dianwen/SIIM_ACR/train/images/1024/mask/1.2.276.0.7230010.3.1.4.8323329.1694.1517875168.978681.png,0.0,0.0,1024,875
1.2.276.0.7230010.3.1.4.8323329.1695.1517875168.978741.png,398678,{},1,0,"{""name"":""rect"",""x"":140,""y"":116,""width"":663,""height"":654}",{},654,rect,663,140,116,/home/dianwen/SIIM_ACR/train/images/1024/dicom/1.2.276.0.7230010.3.1.4.8323329.1695.1517875168.978741.png,/home/dianwen/SIIM_ACR/train/images/1024/mask/1.2.276.0.7230010.3.1.4.8323329.1695.1517875168.978741.png,0.009904109872877598,1.0,770,803
1.2.276.0.7230010.3.1.4.8323329.1696.1517875168.981150.png,327234,{},1,0,"{""name"":""rect"",""x"":93,""y"":192,""width"":720,""height"":782}",{},782,rect,720,93,192,/home/dianwen/SIIM_ACR/train/images/1024/dicom/1.2.276.0.7230010.3.1.4.8323329.1696.1517875168.981150.png,/home/dianwen/SIIM_ACR/train/images/1024/mask/1.2.276.0.7230010.3.1.4.8323329.1696.1517875168.981150.png,0.0,0.0,974,813
1.2.276.0.7230010.3.1.4.8323329.1697.1517875168.995871.png,403922,{},1,0,"{""name"":""rect"",""x"":222,""y"":87,""width"":707,""height"":782}",{},782,rect,707,222,87,/home/dianwen/SIIM_ACR/train/images/1024/dicom/1.2.276.0.7230010.3.1.4.8323329.1697.1517875168.995871.png,/home/dianwen/SIIM_ACR/train/images/1024/mask/1.2.276.0.7230010.3.1.4.8323329.1697.1517875168.995871.png,0.01396465301513672,1.0,869,929
1.2.276.0.7230010.3.1.4.8323329.1698.1517875168.918.png,362418,{},1,0,"{""name"":""rect"",""x"":122,""y"":46,""width"":791,""height"":894}",{},894,rect,791,122,46,/home/dianwen/SIIM_ACR/train/images/1024/dicom/1.2.276.0.7230010.3.1.4.8323329.1698.1517875168.918.png,/home/dianwen/SIIM_ACR/train/images/1024/mask/1.2.276.0.7230010.3.1.4.8323329.1698.1517875168.918.png,0.0,0.0,940,913
1.2.276.0.7230010.3.1.4.8323329.1699.1517875169.6097.png,354475,{},1,0,"{""name"":""rect"",""x"":66,""y"":131,""width"":894,""height"":893}",{},893,rect,894,66,131,/home/dianwen/SIIM_ACR/train/images/1024/dicom/1.2.276.0.7230010.3.1.4.8323329.1699.1517875169.6097.png,/home/dianwen/SIIM_ACR/train/images/1024/mask/1.2.276.0.7230010.3.1.4.8323329.1699.1517875169.6097.png,0.0,0.0,1024,960
1.2.276.0.7230010.3.1.4.8323329.1700.1517875169.6934.png,358959,{},1,0,"{""name"":""rect"",""x"":203,""y"":50,""width"":706,""height"":891}",{},891,rect,706,203,50,/home/dianwen/SIIM_ACR/train/images/1024/dicom/1.2.276.0.7230010.3.1.4.8323329.1700.1517875169.6934.png,/home/dianwen/SIIM_ACR/train/images/1024/mask/1.2.276.0.7230010.3.1.4.8323329.1700.1517875169.6934.png,0.01902543194591999,1.0,941,909
1.2.276.0.7230010.3.1.4.8323329.1701.1517875169.20014.png,436204,{},1,0,"{""name"":""rect"",""x"":45,""y"":135,""width"":890,""height"":861}",{},861,rect,890,45,135,/home/dianwen/SIIM_ACR/train/images/1024/dicom/1.2.276.0.7230010.3.1.4.8323329.1701.1517875169.20014.png,/home/dianwen/SIIM_ACR/train/images/1024/mask/1.2.276.0.7230010.3.1.4.8323329.1701.1517875169.20014.png,0.0,0.0,996,935
1.2.276.0.7230010.3.1.4.8323329.1702.1517875169.44421.png,489282,{},1,0,"{""name"":""rect"",""x"":44,""y"":57,""width"":944,""height"":954}",{},954,rect,944,44,57,/home/dianwen/SIIM_ACR/train/images/1024/dicom/1.2.276.0.7230010.3.1.4.8323329.1702.1517875169.44421.png,/home/dianwen/SIIM_ACR/train/images/1024/mask/1.2.276.0.7230010.3.1.4.8323329.1702.1517875169.44421.png,0.0,0.0,1011,988
1.2.276.0.7230010.3.1.4.8323329.1703.1517875169.24856.png,340174,{},1,0,"{""name"":""rect"",""x"":89,""y"":181,""width"":768,""height"":749}",{},749,rect,768,89,181,/home/dianwen/SIIM_ACR/train/images/1024/dicom/1.2.276.0.7230010.3.1.4.8323329.1703.1517875169.24856.png,/home/dianwen/SIIM_ACR/train/images/1024/mask/1.2.276.0.7230010.3.1.4.8323329.1703.1517875169.24856.png,0.0,0.0,930,857
1.2.276.0.7230010.3.1.4.8323329.1704.1517875169.25690.png,328696,{},1,0,"{""name"":""rect"",""x"":109,""y"":204,""width"":818,""height"":752}",{},752,rect,818,109,204,/home/dianwen/SIIM_ACR/train/images/1024/dicom/1.2.276.0.7230010.3.1.4.8323329.1704.1517875169.25690.png,/home/dianwen/SIIM_ACR/train/images/1024/mask/1.2.276.0.7230010.3.1.4.8323329.1704.1517875169.25690.png,0.0,0.0,956,927
1.2.276.0.7230010.3.1.4.8323329.1705.1517875169.35252.png,407861,{},1,0,"{""name"":""rect"",""x"":58,""y"":122,""width"":870,""height"":780}",{},780,rect,870,58,122,/home/dianwen/SIIM_ACR/train/images/1024/dicom/1.2.276.0.7230010.3.1.4.8323329.1705.1517875169.35252.png,/home/dianwen/SIIM_ACR/train/images/1024/mask/1.2.276.0.7230010.3.1.4.8323329.1705.1517875169.35252.png,0.0,0.0,902,928
1.2.276.0.7230010.3.1.4.8323329.1706.1517875169.28281.png,403198,{},1,0,"{""name"":""rect"",""x"":148,""y"":66,""width"":726,""height"":750}",{},750,rect,726,148,66,/home/dianwen/SIIM_ACR/train/images/1024/dicom/1.2.276.0.7230010.3.1.4.8323329.1706.1517875169.28281.png,/home/dianwen/SIIM_ACR/train/images/1024/mask/1.2.276.0.7230010.3.1.4.8323329.1706.1517875169.28281.png,0.0,0.0,816,874
1.2.276.0.7230010.3.1.4.8323329.1707.1517875169.58985.png,407229,{},1,0,"{""name"":""rect"",""x"":94,""y"":114,""width"":830,""height"":840}",{},840,rect,830,94,114,/home/dianwen/SIIM_ACR/train/images/1024/dicom/1.2.276.0.7230010.3.1.4.8323329.1707.1517875169.58985.png,/home/dianwen/SIIM_ACR/train/images/1024/mask/1.2.276.0.7230010.3.1.4.8323329.1707.1517875169.58985.png,0.0,0.0,954,924
1.2.276.0.7230010.3.1.4.8323329.1708.1517875169.43102.png,334676,{},1,0,"{""name"":""rect"",""x"":86,""y"":43,""width"":870,""height"":976}",{},976,rect,870,86,43,/home/dianwen/SIIM_ACR/train/images/1024/dicom/1.2.276.0.7230010.3.1.4.8323329.1708.1517875169.43102.png,/home/dianwen/SIIM_ACR/train/images/1024/mask/1.2.276.0.7230010.3.1.4.8323329.1708.1517875169.43102.png,0.0,0.0,1019,956
1.2.276.0.7230010.3.1.4.8323329.1709.1517875169.49008.png,422032,{},1,0,"{""name"":""rect"",""x"":178,""y"":103,""width"":790,""height"":745}",{},745,rect,790,178,103,/home/dianwen/SIIM_ACR/train/images/1024/dicom/1.2.276.0.7230010.3.1.4.8323329.1709.1517875169.49008.png,/home/dianwen/SIIM_ACR/train/images/1024/mask/1.2.276.0.7230010.3.1.4.8323329.1709.1517875169.49008.png,0.0,0.0,848,968
1.2.276.0.7230010.3.1.4.8323329.1710.1517875169.45651.png,377909,{},1,0,"{""name"":""rect"",""x"":112,""y"":156,""width"":767,""height"":647}",{},647,rect,767,112,156,/home/dianwen/SIIM_ACR/train/images/1024/dicom/1.2.276.0.7230010.3.1.4.8323329.1710.1517875169.45651.png,/home/dianwen/SIIM_ACR/train/images/1024/mask/1.2.276.0.7230010.3.1.4.8323329.1710.1517875169.45651.png,0.0,0.0,803,879
1.2.276.0.7230010.3.1.4.8323329.1711.1517875169.50134.png,339928,{},1,0,"{""name"":""rect"",""x"":138,""y"":75,""width"":775,""height"":712}",{},712,rect,775,138,75,/home/dianwen/SIIM_ACR/train/images/1024/dicom/1.2.276.0.7230010.3.1.4.8323329.1711.1517875169.50134.png,/home/dianwen/SIIM_ACR/train/images/1024/mask/1.2.276.0.7230010.3.1.4.8323329.1711.1517875169.50134.png,0.0,0.0,787,913
1.2.276.0.7230010.3.1.4.8323329.1712.1517875169.64732.png,315744,{},1,0,"{""name"":""rect"",""x"":184,""y"":160,""width"":756,""height"":778}",{},778,rect,756,184,160,/home/dianwen/SIIM_ACR/train/images/1024/dicom/1.2.276.0.7230010.3.1.4.8323329.1712.1517875169.64732.png,/home/dianwen/SIIM_ACR/train/images/1024/mask/1.2.276.0.7230010.3.1.4.8323329.1712.1517875169.64732.png,0.0,0.0,938,940
1.2.276.0.7230010.3.1.4.8323329.1713.1517875169.64948.png,435934,{},1,0,"{""name"":""rect"",""x"":170,""y"":40,""width"":818,""height"":769}",{},769,rect,818,170,40,/home/dianwen/SIIM_ACR/train/images/1024/dicom/1.2.276.0.7230010.3.1.4.8323329.1713.1517875169.64948.png,/home/dianwen/SIIM_ACR/train/images/1024/mask/1.2.276.0.7230010.3.1.4.8323329.1713.1517875169.64948.png,0.01735687255859375,1.0,809,988
1.2.276.0.7230010.3.1.4.8323329.1714.1517875169.67779.png,315195,{},1,0,"{""name"":""rect"",""x"":194,""y"":162,""width"":710,""height"":643}",{},643,rect,710,194,162,/home/dianwen/SIIM_ACR/train/images/1024/dicom/1.2.276.0.7230010.3.1.4.8323329.1714.1517875169.67779.png,/home/dianwen/SIIM_ACR/train/images/1024/mask/1.2.276.0.7230010.3.1.4.8323329.1714.1517875169.67779.png,0.0,0.0,805,904
1.2.276.0.7230010.3.1.4.8323329.1715.1517875169.84126.png,407035,{},1,0,"{""name"":""rect"",""x"":174,""y"":64,""width"":675,""height"":751}",{},751,rect,675,174,64,/home/dianwen/SIIM_ACR/train/images/1024/dicom/1.2.276.0.7230010.3.1.4.8323329.1715.1517875169.84126.png,/home/dianwen/SIIM_ACR/train/images/1024/mask/1.2.276.0.7230010.3.1.4.8323329.1715.1517875169.84126.png,0.0,0.0,815,849
1.2.276.0.7230010.3.1.4.8323329.1716.1517875169.81362.png,446965,{},1,0,"{""name"":""rect"",""x"":126,""y"":73,""width"":818,""height"":932}",{},932,rect,818,126,73,/home/dianwen/SIIM_ACR/train/images/1024/dicom/1.2.276.0.7230010.3.1.4.8323329.1716.1517875169.81362.png,/home/dianwen/SIIM_ACR/train/images/1024/mask/1.2.276.0.7230010.3.1.4.8323329.1716.1517875169.81362.png,0.0,0.0,1005,944
1.2.276.0.7230010.3.1.4.8323329.1717.1517875169.86570.png,411456,{},1,0,"{""name"":""rect"",""x"":111,""y"":93,""width"":784,""height"":878}",{},878,rect,784,111,93,/home/dianwen/SIIM_ACR/train/images/1024/dicom/1.2.276.0.7230010.3.1.4.8323329.1717.1517875169.86570.png,/home/dianwen/SIIM_ACR/train/images/1024/mask/1.2.276.0.7230010.3.1.4.8323329.1717.1517875169.86570.png,0.006208419799804688,1.0,971,895
1.2.276.0.7230010.3.1.4.8323329.1718.1517875169.89233.png,428842,{},1,0,"{""name"":""rect"",""x"":75,""y"":45,""width"":846,""height"":910}",{},910,rect,846,75,45,/home/dianwen/SIIM_ACR/train/images/1024/dicom/1.2.276.0.7230010.3.1.4.8323329.1718.1517875169.89233.png,/home/dianwen/SIIM_ACR/train/images/1024/mask/1.2.276.0.7230010.3.1.4.8323329.1718.1517875169.89233.png,0.0,0.0,955,921
1.2.276.0.7230010.3.1.4.8323329.1719.1517875169.94205.png,359951,{},1,0,"{""name"":""rect"",""x"":15,""y"":83,""width"":908,""height"":768}",{},768,rect,908,15,83,/home/dianwen/SIIM_ACR/train/images/1024/dicom/1.2.276.0.7230010.3.1.4.8323329.1719.1517875169.94205.png,/home/dianwen/SIIM_ACR/train/images/1024/mask/1.2.276.0.7230010.3.1.4.8323329.1719.1517875169.94205.png,0.0,0.0,851,923
1.2.276.0.7230010.3.1.4.8323329.1720.1517875169.100568.png,399461,{},1,0,"{""name"":""rect"",""x"":159,""y"":115,""width"":811,""height"":835}",{},835,rect,811,159,115,/home/dianwen/SIIM_ACR/train/images/1024/dicom/1.2.276.0.7230010.3.1.4.8323329.1720.1517875169.100568.png,/home/dianwen/SIIM_ACR/train/images/1024/mask/1.2.276.0.7230010.3.1.4.8323329.1720.1517875169.100568.png,0.0,0.0,950,970
1.2.276.0.7230010.3.1.4.8323329.1721.1517875169.109286.png,406739,{},1,0,"{""name"":""rect"",""x"":63,""y"":62,""width"":793,""height"":840}",{},840,rect,793,63,62,/home/dianwen/SIIM_ACR/train/images/1024/dicom/1.2.276.0.7230010.3.1.4.8323329.1721.1517875169.109286.png,/home/dianwen/SIIM_ACR/train/images/1024/mask/1.2.276.0.7230010.3.1.4.8323329.1721.1517875169.109286.png,0.005192756652832031,1.0,902,856
1.2.276.0.7230010.3.1.4.8323329.1722.1517875169.105378.png,437047,{},1,0,"{""name"":""rect"",""x"":112,""y"":125,""width"":812,""height"":842}",{},842,rect,812,112,125,/home/dianwen/SIIM_ACR/train/images/1024/dicom/1.2.276.0.7230010.3.1.4.8323329.1722.1517875169.105378.png,/home/dianwen/SIIM_ACR/train/images/1024/mask/1.2.276.0.7230010.3.1.4.8323329.1722.1517875169.105378.png,0.0,0.0,967,924
1.2.276.0.7230010.3.1.4.8323329.1723.1517875169.107832.png,369804,{},1,0,"{""name"":""rect"",""x"":98,""y"":154,""width"":813,""height"":780}",{},780,rect,813,98,154,/home/dianwen/SIIM_ACR/train/images/1024/dicom/1.2.276.0.7230010.3.1.4.8323329.1723.1517875169.107832.png,/home/dianwen/SIIM_ACR/train/images/1024/mask/1.2.276.0.7230010.3.1.4.8323329.1723.1517875169.107832.png,0.0,0.0,934,911
1.2.276.0.7230010.3.1.4.8323329.1724.1517875169.115602.png,393617,{},1,0,"{""name"":""rect"",""x"":51,""y"":113,""width"":965,""height"":857}",{},857,rect,965,51,113,/home/dianwen/SIIM_ACR/train/images/1024/dicom/1.2.276.0.7230010.3.1.4.8323329.1724.1517875169.115602.png,/home/dianwen/SIIM_ACR/train/images/1024/mask/1.2.276.0.7230010.3.1.4.8323329.1724.1517875169.115602.png,0.0,0.0,970,1016
1.2.276.0.7230010.3.1.4.8323329.1725.1517875169.119831.png,437658,{},1,0,"{""name"":""rect"",""x"":78,""y"":136,""width"":861,""height"":888}",{},888,rect,861,78,136,/home/dianwen/SIIM_ACR/train/images/1024/dicom/1.2.276.0.7230010.3.1.4.8323329.1725.1517875169.119831.png,/home/dianwen/SIIM_ACR/train/images/1024/mask/1.2.276.0.7230010.3.1.4.8323329.1725.1517875169.119831.png,0.05165302380919457,1.0,1024,939
1.2.276.0.7230010.3.1.4.8323329.1726.1517875169.120768.png,346041,{},1,0,"{""name"":""rect"",""x"":51,""y"":60,""width"":850,""height"":879}",{},879,rect,850,51,60,/home/dianwen/SIIM_ACR/train/images/1024/dicom/1.2.276.0.7230010.3.1.4.8323329.1726.1517875169.120768.png,/home/dianwen/SIIM_ACR/train/images/1024/mask/1.2.276.0.7230010.3.1.4.8323329.1726.1517875169.120768.png,0.0,0.0,939,901
1.2.276.0.7230010.3.1.4.8323329.1727.1517875169.127192.png,436248,{},1,0,"{""name"":""rect"",""x"":78,""y"":134,""width"":855,""height"":882}",{},882,rect,855,78,134,/home/dianwen/SIIM_ACR/train/images/1024/dicom/1.2.276.0.7230010.3.1.4.8323329.1727.1517875169.127192.png,/home/dianwen/SIIM_ACR/train/images/1024/mask/1.2.276.0.7230010.3.1.4.8323329.1727.1517875169.127192.png,0.0,0.0,1016,933
1.2.276.0.7230010.3.1.4.8323329.1728.1517875169.130349.png,387566,{},1,0,"{""name"":""rect"",""x"":265,""y"":94,""width"":715,""height"":696}",{},696,rect,715,265,94,/home/dianwen/SIIM_ACR/train/images/1024/dicom/1.2.276.0.7230010.3.1.4.8323329.1728.1517875169.130349.png,/home/dianwen/SIIM_ACR/train/images/1024/mask/1.2.276.0.7230010.3.1.4.8323329.1728.1517875169.130349.png,0.0,0.0,790,980
1.2.276.0.7230010.3.1.4.8323329.1729.1517875169.130513.png,459689,{},1,0,"{""name"":""rect"",""x"":100,""y"":69,""width"":810,""height"":783}",{},783,rect,810,100,69,/home/dianwen/SIIM_ACR/train/images/1024/dicom/1.2.276.0.7230010.3.1.4.8323329.1729.1517875169.130513.png,/home/dianwen/SIIM_ACR/train/images/1024/mask/1.2.276.0.7230010.3.1.4.8323329.1729.1517875169.130513.png,0.0,0.0,852,910
1.2.276.0.7230010.3.1.4.8323329.1730.1517875169.140930.png,327605,{},1,0,"{""name"":""rect"",""x"":167,""y"":74,""width"":729,""height"":868}",{},868,rect,729,167,74,/home/dianwen/SIIM_ACR/train/images/1024/dicom/1.2.276.0.7230010.3.1.4.8323329.1730.1517875169.140930.png,/home/dianwen/SIIM_ACR/train/images/1024/mask/1.2.276.0.7230010.3.1.4.8323329.1730.1517875169.140930.png,0.0,0.0,942,896
1.2.276.0.7230010.3.1.4.8323329.1731.1517875169.148664.png,400096,{},1,0,"{""name"":""rect"",""x"":145,""y"":202,""width"":660,""height"":807}",{},807,rect,660,145,202,/home/dianwen/SIIM_ACR/train/images/1024/dicom/1.2.276.0.7230010.3.1.4.8323329.1731.1517875169.148664.png,/home/dianwen/SIIM_ACR/train/images/1024/mask/1.2.276.0.7230010.3.1.4.8323329.1731.1517875169.148664.png,0.0,0.0,1009,805
1.2.276.0.7230010.3.1.4.8323329.1732.1517875169.156805.png,379031,{},1,0,"{""name"":""rect"",""x"":207,""y"":144,""width"":677,""height"":774}",{},774,rect,677,207,144,/home/dianwen/SIIM_ACR/train/images/1024/dicom/1.2.276.0.7230010.3.1.4.8323329.1732.1517875169.156805.png,/home/dianwen/SIIM_ACR/train/images/1024/mask/1.2.276.0.7230010.3.1.4.8323329.1732.1517875169.156805.png,0.05521329864859581,1.0,918,884
1.2.276.0.7230010.3.1.4.8323329.1733.1517875169.151251.png,437574,{},1,0,"{""name"":""rect"",""x"":91,""y"":101,""width"":839,""height"":804}",{},804,rect,839,91,101,/home/dianwen/SIIM_ACR/train/images/1024/dicom/1.2.276.0.7230010.3.1.4.8323329.1733.1517875169.151251.png,/home/dianwen/SIIM_ACR/train/images/1024/mask/1.2.276.0.7230010.3.1.4.8323329.1733.1517875169.151251.png,0.0,0.0,905,930
1.2.276.0.7230010.3.1.4.8323329.1734.1517875169.155829.png,428038,{},1,0,"{""name"":""rect"",""x"":45,""y"":143,""width"":922,""height"":775}",{},775,rect,922,45,143,/home/dianwen/SIIM_ACR/train/images/1024/dicom/1.2.276.0.7230010.3.1.4.8323329.1734.1517875169.155829.png,/home/dianwen/SIIM_ACR/train/images/1024/mask/1.2.276.0.7230010.3.1.4.8323329.1734.1517875169.155829.png,0.0,0.0,918,967
1.2.276.0.7230010.3.1.4.8323329.1735.1517875169.165453.png,372333,{},1,0,"{""name"":""rect"",""x"":189,""y"":119,""width"":680,""height"":723}",{},723,rect,680,189,119,/home/dianwen/SIIM_ACR/train/images/1024/dicom/1.2.276.0.7230010.3.1.4.8323329.1735.1517875169.165453.png,/home/dianwen/SIIM_ACR/train/images/1024/mask/1.2.276.0.7230010.3.1.4.8323329.1735.1517875169.165453.png,0.0,0.0,842,869
1.2.276.0.7230010.3.1.4.8323329.1736.1517875169.167112.png,415831,{},1,0,"{""name"":""rect"",""x"":122,""y"":138,""width"":769,""height"":703}",{},703,rect,769,122,138,/home/dianwen/SIIM_ACR/train/images/1024/dicom/1.2.276.0.7230010.3.1.4.8323329.1736.1517875169.167112.png,/home/dianwen/SIIM_ACR/train/images/1024/mask/1.2.276.0.7230010.3.1.4.8323329.1736.1517875169.167112.png,0.0,0.0,841,891
1.2.276.0.7230010.3.1.4.8323329.1737.1517875169.171778.png,287561,{},1,0,"{""name"":""rect"",""x"":129,""y"":96,""width"":631,""height"":740}",{},740,rect,631,129,96,/home/dianwen/SIIM_ACR/train/images/1024/dicom/1.2.276.0.7230010.3.1.4.8323329.1737.1517875169.171778.png,/home/dianwen/SIIM_ACR/train/images/1024/mask/1.2.276.0.7230010.3.1.4.8323329.1737.1517875169.171778.png,0.0,0.0,836,760
1.2.276.0.7230010.3.1.4.8323329.1738.1517875169.176159.png,422440,{},1,0,"{""name"":""rect"",""x"":144,""y"":69,""width"":697,""height"":854}",{},854,rect,697,144,69,/home/dianwen/SIIM_ACR/train/images/1024/dicom/1.2.276.0.7230010.3.1.4.8323329.1738.1517875169.176159.png,/home/dianwen/SIIM_ACR/train/images/1024/mask/1.2.276.0.7230010.3.1.4.8323329.1738.1517875169.176159.png,0.0,0.0,923,841
1.2.276.0.7230010.3.1.4.8323329.1739.1517875169.194352.png,344611,{},1,0,"{""name"":""rect"",""x"":147,""y"":180,""width"":737,""height"":844}",{},844,rect,737,147,180,/home/dianwen/SIIM_ACR/train/images/1024/dicom/1.2.276.0.7230010.3.1.4.8323329.1739.1517875169.194352.png,/home/dianwen/SIIM_ACR/train/images/1024/mask/1.2.276.0.7230010.3.1.4.8323329.1739.1517875169.194352.png,0.0,0.0,1024,884
1.2.276.0.7230010.3.1.4.8323329.1740.1517875169.196588.png,437473,{},1,0,"{""name"":""rect"",""x"":32,""y"":48,""width"":809,""height"":719}",{},719,rect,809,32,48,/home/dianwen/SIIM_ACR/train/images/1024/dicom/1.2.276.0.7230010.3.1.4.8323329.1740.1517875169.196588.png,/home/dianwen/SIIM_ACR/train/images/1024/mask/1.2.276.0.7230010.3.1.4.8323329.1740.1517875169.196588.png,0.0,0.0,767,841
1.2.276.0.7230010.3.1.4.8323329.1741.1517875169.196573.png,424782,{},1,0,"{""name"":""rect"",""x"":5,""y"":23,""width"":827,""height"":743}",{},743,rect,827,5,23,/home/dianwen/SIIM_ACR/train/images/1024/dicom/1.2.276.0.7230010.3.1.4.8323329.1741.1517875169.196573.png,/home/dianwen/SIIM_ACR/train/images/1024/mask/1.2.276.0.7230010.3.1.4.8323329.1741.1517875169.196573.png,0.04519084095954895,1.0,766,832
1.2.276.0.7230010.3.1.4.8323329.1742.1517875169.199023.png,334187,{},1,0,"{""name"":""rect"",""x"":183,""y"":83,""width"":723,""height"":780}",{},780,rect,723,183,83,/home/dianwen/SIIM_ACR/train/images/1024/dicom/1.2.276.0.7230010.3.1.4.8323329.1742.1517875169.199023.png,/home/dianwen/SIIM_ACR/train/images/1024/mask/1.2.276.0.7230010.3.1.4.8323329.1742.1517875169.199023.png,0.0,0.0,863,906
1.2.276.0.7230010.3.1.4.8323329.1743.1517875169.212248.png,394800,{},1,0,"{""name"":""rect"",""x"":121,""y"":89,""width"":821,""height"":844}",{},844,rect,821,121,89,/home/dianwen/SIIM_ACR/train/images/1024/dicom/1.2.276.0.7230010.3.1.4.8323329.1743.1517875169.212248.png,/home/dianwen/SIIM_ACR/train/images/1024/mask/1.2.276.0.7230010.3.1.4.8323329.1743.1517875169.212248.png,0.0,0.0,933,942
1.2.276.0.7230010.3.1.4.8323329.1744.1517875169.213412.png,299036,{},1,0,"{""name"":""rect"",""x"":128,""y"":84,""width"":842,""height"":859}",{},859,rect,842,128,84,/home/dianwen/SIIM_ACR/train/images/1024/dicom/1.2.276.0.7230010.3.1.4.8323329.1744.1517875169.213412.png,/home/dianwen/SIIM_ACR/train/images/1024/mask/1.2.276.0.7230010.3.1.4.8323329.1744.1517875169.213412.png,0.0,0.0,943,970
1.2.276.0.7230010.3.1.4.8323329.1745.1517875169.230352.png,359375,{},1,0,"{""name"":""rect"",""x"":156,""y"":58,""width"":766,""height"":962}",{},962,rect,766,156,58,/home/dianwen/SIIM_ACR/train/images/1024/dicom/1.2.276.0.7230010.3.1.4.8323329.1745.1517875169.230352.png,/home/dianwen/SIIM_ACR/train/images/1024/mask/1.2.276.0.7230010.3.1.4.8323329.1745.1517875169.230352.png,0.0,0.0,1020,922
1.2.276.0.7230010.3.1.4.8323329.1746.1517875169.230417.png,303826,{},1,0,"{""name"":""rect"",""x"":99,""y"":47,""width"":881,""height"":879}",{},879,rect,881,99,47,/home/dianwen/SIIM_ACR/train/images/1024/dicom/1.2.276.0.7230010.3.1.4.8323329.1746.1517875169.230417.png,/home/dianwen/SIIM_ACR/train/images/1024/mask/1.2.276.0.7230010.3.1.4.8323329.1746.1517875169.230417.png,0.0,0.0,926,980
1.2.276.0.7230010.3.1.4.8323329.1747.1517875169.224029.png,422543,{},1,0,"{""name"":""rect"",""x"":64,""y"":87,""width"":919,""height"":842}",{},842,rect,919,64,87,/home/dianwen/SIIM_ACR/train/images/1024/dicom/1.2.276.0.7230010.3.1.4.8323329.1747.1517875169.224029.png,/home/dianwen/SIIM_ACR/train/images/1024/mask/1.2.276.0.7230010.3.1.4.8323329.1747.1517875169.224029.png,0.0,0.0,929,983
1.2.276.0.7230010.3.1.4.8323329.1748.1517875169.223209.png,440248,{},1,0,"{""name"":""rect"",""x"":81,""y"":51,""width"":835,""height"":808}",{},808,rect,835,81,51,/home/dianwen/SIIM_ACR/train/images/1024/dicom/1.2.276.0.7230010.3.1.4.8323329.1748.1517875169.223209.png,/home/dianwen/SIIM_ACR/train/images/1024/mask/1.2.276.0.7230010.3.1.4.8323329.1748.1517875169.223209.png,0.0,0.0,859,916
1.2.276.0.7230010.3.1.4.8323329.1749.1517875169.236838.png,404904,{},1,0,"{""name"":""rect"",""x"":200,""y"":44,""width"":701,""height"":689}",{},689,rect,701,200,44,/home/dianwen/SIIM_ACR/train/images/1024/dicom/1.2.276.0.7230010.3.1.4.8323329.1749.1517875169.236838.png,/home/dianwen/SIIM_ACR/train/images/1024/mask/1.2.276.0.7230010.3.1.4.8323329.1749.1517875169.236838.png,0.0,0.0,733,901
1.2.276.0.7230010.3.1.4.8323329.1750.1517875169.234587.png,380410,{},1,0,"{""name"":""rect"",""x"":118,""y"":66,""width"":733,""height"":739}",{},739,rect,733,118,66,/home/dianwen/SIIM_ACR/train/images/1024/dicom/1.2.276.0.7230010.3.1.4.8323329.1750.1517875169.234587.png,/home/dianwen/SIIM_ACR/train/images/1024/mask/1.2.276.0.7230010.3.1.4.8323329.1750.1517875169.234587.png,0.006337165832519531,1.0,805,851
1.2.276.0.7230010.3.1.4.8323329.1751.1517875169.242980.png,313074,{},1,0,"{""name"":""rect"",""x"":142,""y"":40,""width"":762,""height"":634}",{},634,rect,762,142,40,/home/dianwen/SIIM_ACR/train/images/1024/dicom/1.2.276.0.7230010.3.1.4.8323329.1751.1517875169.242980.png,/home/dianwen/SIIM_ACR/train/images/1024/mask/1.2.276.0.7230010.3.1.4.8323329.1751.1517875169.242980.png,0.025460243225097656,1.0,674,904
1.2.276.0.7230010.3.1.4.8323329.1752.1517875169.253566.png,351487,{},1,0,"{""name"":""rect"",""x"":141,""y"":46,""width"":791,""height"":945}",{},945,rect,791,141,46,/home/dianwen/SIIM_ACR/train/images/1024/dicom/1.2.276.0.7230010.3.1.4.8323329.1752.1517875169.253566.png,/home/dianwen/SIIM_ACR/train/images/1024/mask/1.2.276.0.7230010.3.1.4.8323329.1752.1517875169.253566.png,0.0,0.0,991,932
1.2.276.0.7230010.3.1.4.8323329.1753.1517875169.257388.png,399343,{},1,0,"{""name"":""rect"",""x"":190,""y"":27,""width"":694,""height"":733}",{},733,rect,694,190,27,/home/dianwen/SIIM_ACR/train/images/1024/dicom/1.2.276.0.7230010.3.1.4.8323329.1753.1517875169.257388.png,/home/dianwen/SIIM_ACR/train/images/1024/mask/1.2.276.0.7230010.3.1.4.8323329.1753.1517875169.257388.png,0.0,0.0,760,884
1.2.276.0.7230010.3.1.4.8323329.1754.1517875169.260175.png,418838,{},1,0,"{""name"":""rect"",""x"":186,""y"":129,""width"":773,""height"":663}",{},663,rect,773,186,129,/home/dianwen/SIIM_ACR/train/images/1024/dicom/1.2.276.0.7230010.3.1.4.8323329.1754.1517875169.260175.png,/home/dianwen/SIIM_ACR/train/images/1024/mask/1.2.276.0.7230010.3.1.4.8323329.1754.1517875169.260175.png,0.010120391845703123,1.0,792,959
1.2.276.0.7230010.3.1.4.8323329.1755.1517875169.266542.png,346239,{},1,0,"{""name"":""rect"",""x"":93,""y"":18,""width"":809,""height"":784}",{},784,rect,809,93,18,/home/dianwen/SIIM_ACR/train/images/1024/dicom/1.2.276.0.7230010.3.1.4.8323329.1755.1517875169.266542.png,/home/dianwen/SIIM_ACR/train/images/1024/mask/1.2.276.0.7230010.3.1.4.8323329.1755.1517875169.266542.png,0.006267547607421875,1.0,802,902
1.2.276.0.7230010.3.1.4.8323329.1756.1517875169.270791.png,427030,{},1,0,"{""name"":""rect"",""x"":82,""y"":137,""width"":853,""height"":784}",{},784,rect,853,82,137,/home/dianwen/SIIM_ACR/train/images/1024/dicom/1.2.276.0.7230010.3.1.4.8323329.1756.1517875169.270791.png,/home/dianwen/SIIM_ACR/train/images/1024/mask/1.2.276.0.7230010.3.1.4.8323329.1756.1517875169.270791.png,0.0064697265625,1.0,921,935
1.2.276.0.7230010.3.1.4.8323329.1757.1517875169.283626.png,353228,{},1,0,"{""name"":""rect"",""x"":51,""y"":48,""width"":885,""height"":793}",{},793,rect,885,51,48,/home/dianwen/SIIM_ACR/train/images/1024/dicom/1.2.276.0.7230010.3.1.4.8323329.1757.1517875169.283626.png,/home/dianwen/SIIM_ACR/train/images/1024/mask/1.2.276.0.7230010.3.1.4.8323329.1757.1517875169.283626.png,0.0,0.0,841,936
1.2.276.0.7230010.3.1.4.8323329.1758.1517875169.288517.png,439617,{},1,0,"{""name"":""rect"",""x"":47,""y"":82,""width"":889,""height"":873}",{},873,rect,889,47,82,/home/dianwen/SIIM_ACR/train/images/1024/dicom/1.2.276.0.7230010.3.1.4.8323329.1758.1517875169.288517.png,/home/dianwen/SIIM_ACR/train/images/1024/mask/1.2.276.0.7230010.3.1.4.8323329.1758.1517875169.288517.png,0.0,0.0,955,936
1.2.276.0.7230010.3.1.4.8323329.1759.1517875169.284901.png,316758,{},1,0,"{""name"":""rect"",""x"":78,""y"":167,""width"":820,""height"":819}",{},819,rect,820,78,167,/home/dianwen/SIIM_ACR/train/images/1024/dicom/1.2.276.0.7230010.3.1.4.8323329.1759.1517875169.284901.png,/home/dianwen/SIIM_ACR/train/images/1024/mask/1.2.276.0.7230010.3.1.4.8323329.1759.1517875169.284901.png,0.015148162841796875,1.0,986,898
1.2.276.0.7230010.3.1.4.8323329.1760.1517875169.291189.png,355879,{},1,0,"{""name"":""rect"",""x"":80,""y"":126,""width"":881,""height"":835}",{},835,rect,881,80,126,/home/dianwen/SIIM_ACR/train/images/1024/dicom/1.2.276.0.7230010.3.1.4.8323329.1760.1517875169.291189.png,/home/dianwen/SIIM_ACR/train/images/1024/mask/1.2.276.0.7230010.3.1.4.8323329.1760.1517875169.291189.png,0.0,0.0,961,961
1.2.276.0.7230010.3.1.4.8323329.1761.1517875169.293784.png,423364,{},1,0,"{""name"":""rect"",""x"":134,""y"":53,""width"":726,""height"":746}",{},746,rect,726,134,53,/home/dianwen/SIIM_ACR/train/images/1024/dicom/1.2.276.0.7230010.3.1.4.8323329.1761.1517875169.293784.png,/home/dianwen/SIIM_ACR/train/images/1024/mask/1.2.276.0.7230010.3.1.4.8323329.1761.1517875169.293784.png,0.0,0.0,799,860
1.2.276.0.7230010.3.1.4.8323329.1762.1517875169.298504.png,362428,{},1,0,"{""name"":""rect"",""x"":26,""y"":56,""width"":954,""height"":733}",{},733,rect,954,26,56,/home/dianwen/SIIM_ACR/train/images/1024/dicom/1.2.276.0.7230010.3.1.4.8323329.1762.1517875169.298504.png,/home/dianwen/SIIM_ACR/train/images/1024/mask/1.2.276.0.7230010.3.1.4.8323329.1762.1517875169.298504.png,0.0,0.0,789,980
1.2.276.0.7230010.3.1.4.8323329.1763.1517875169.306936.png,315665,{},1,0,"{""name"":""rect"",""x"":126,""y"":85,""width"":813,""height"":752}",{},752,rect,813,126,85,/home/dianwen/SIIM_ACR/train/images/1024/dicom/1.2.276.0.7230010.3.1.4.8323329.1763.1517875169.306936.png,/home/dianwen/SIIM_ACR/train/images/1024/mask/1.2.276.0.7230010.3.1.4.8323329.1763.1517875169.306936.png,0.0,0.0,837,939
1.2.276.0.7230010.3.1.4.8323329.1764.1517875169.306622.png,393579,{},1,0,"{""name"":""rect"",""x"":93,""y"":138,""width"":842,""height"":878}",{},878,rect,842,93,138,/home/dianwen/SIIM_ACR/train/images/1024/dicom/1.2.276.0.7230010.3.1.4.8323329.1764.1517875169.306622.png,/home/dianwen/SIIM_ACR/train/images/1024/mask/1.2.276.0.7230010.3.1.4.8323329.1764.1517875169.306622.png,0.0,0.0,1016,935
